〜	~
 \,	, 
 ；大	 大
 \^窓論	 醫窓論
 」	」
 \|	|
 «파	 α파
 → 年生	 一年生
 • 	·
 ·	·
 0자	 O자
 8형	 B형
 a파	 α파
 K門	 肛門
 M發	 竝發
 of주 	 아주 
 가 	가 
 가 느끼	가 느끼
 가 많	가 많
 가 없	가 없
 가 우선	가 우선
 가 있	가 있
 가 장	 가장
 가능동	 가 능동
 가지 고 	 가지고 
 假하	 煆하
 癎과 癎	 癲과 癎
 癎狂	 癲狂
 肝命	 肝兪
 감 기	 감기
 감 소	 감소
 疳감	 府감
 減으	 鍼으
 강 하	 강하
 皆 	 皆
 거 기	 거기
 거나 	거나 
 건 조	 건조
 乾重	 乾薑
 乾置	 乾薑
 검 사	 검사
 臉穴	 兪穴
 것 은	 것은 
 것 이	 것이
 게 	게 
 게 한	게 한
 겠	겠
 肩 痛	 肩痛
 결 체	 결체
 경 우	 경우
 竟科	 莧科
 경탁	 경락
 계 지	 계지
 故 	 故
 고 려	 고려
 고 루	 고루
 고 있	고 있
 고 주파	 고주파
 고\, 	고, 
 과 	과 
 과 다하	 과다하
 과의 	과의 
 관 심	 관심
 교 통	 교통
 구 분	 구분
 救 해	 救해
 求의 	 朮의 
 국 소	 국소
 菌片	 苞片
 그 리	 그리
 근 거	 근거
 근 위	 근위
 근 치	 근치
 根蜜	 根莖
 根塞	 根莖
 根垂	 根莖
 根楚	 根莖
 根巷	 根莖
 根華	 根莖
 급 성	 급성
 急 痛	 急痛
 기 본	 기본
 기 억	 기억
 기끔	 가끔
 기도 한다	기도한다
 기등	 기둥
 嗜血	 喀血
 긴 장	 긴장
 길 고	 길고
 까지	까지
 까지 	까지
 꿇여	 끓여
 꿇인	 끓인
 나 	나 
 나 타	 나타
 나 타나	 나타나
 나뉘 	 나눠 
 나둬 	 나눠 
 나타 나	 나타나
 暖氣	 噯氣
 내 리	 내리
 내고 	내고 
 너 무	 너무
 느 끼	 느끼
 느침	 느낌
 는 것	는 것
 는경우	는 경우
 늘 어나	 늘어나
 니 	니 
 니\,	니,
 니•	 나
 니다	니다
 닌	닌
 다 \^다	 다룬다
 다 만	 다만
 다 스	 다스
 다 양	 다양
 다 음	 다음
 다\.	다.
 다는 	다는 
 단 계	 단계
 單織	 單蛾
 달 여	 달여
 膽性	 膿性
 膽瘡	 膿瘡
 膽血	 膿血
 닷게	 낫게
 當 	 當
 대 상	 대상
 대 신	 대신
 대 체	 대체
 大 便	 大便
 대 한	 대한
 大棄	 大棗
 大論	大論
 大裏	 大棗
 大勝	 大腸
 德가	 穗가
 德血	 瀉血
 데\,	데,
 도 	도 
 도 가능	도 가능
 도 있	도 있
 도록 	도록 
 都門	 郄門
 도음	 도움
 도좋	도 좋
 督經	 腎經
 獨氣	 濁氣
 獨陰	 濁陰
 돗 하	 듯 하
 동 반	 동반
 同 方	 同方
 동 시	 동시
 疼出血	 痔出血
 되 고 	 되고 
 된 다고	된다고
 두 통	 두통
 頭 痛	 頭痛
 둥\(	 등(
 둥과	 등과
 둥과 	 등과 
 둥도	 등도
 둥에	 등에
 둥으	 등으
 둥은	 등은
 둥을	 등을 
 둥을	 등을
 둥의	 등의
 둥의 	 등의 
 둥이	 등이
 둥이 	 등이 
 들 	들 
 들도 	들도 
 들에	들에
 들에 	들에 
 들은 	들은 
 들을 	들을 
 들의 	들의 
 들이 	들이 
 듬을	 뜸을
 등 이 	 등이 
 腾中	 臍中
 디루	 다루
 디음	 다음
 때이 	 때 이 
 떨 어	 떨어
 떻	떻
 또 한 	 또한 
 뛰 	 뛰
 띠라	 따라
 라	라
 라 	라 
 라고 	라고 
 라는	라는
 라는 	라는 
 라도 	라도 
 鸾毛	 茸毛
 람	람
 랑	랑
 랫	랫
 략	략
 량	량
 런	런
 럴 	럴 
 럽	럽
 렇	렇
 려	려
 력	력
 련	련
 蓮白	 薤白
 렸	렸
 례	례
 로	로
 로 	로 
 로 한	로 한
 로\,	로,
 로는	로는
 로서 	로서 
 로써 	로써 
 록 	록 
 論』	論』
 론적	론적
 뢰	뢰
 료	료
 療血	 瘀血
 류 	류 
 瘤疾	 痼疾
 륙	륙
 률	률
 른	른
 를	를
 를 	를 
 름	름
 鱗垂	 鱗莖
 림	림
 마 시	 마시
 마 신	 마신
 마 음	 마음
 膜癌	 膿瘍
 膜肢	 瞑眩
 膜弦	 瞑眩
 膜血	 膿血
 만 	만 
 만 든	 만든
 만 들	 만들
 만 성 	 만성 
 만 약	 만약
 만\,	만,
 萬白	 蔥白
 蠻熱	 鬱熱
 蠻證	 鬱證
 많 	 많
 말 고 	 말고 
 말 초	 말초
 먹 	 먹
 먼 저	 먼저
 멀 미	 멀미
 며 	며 
 며\,	며,
 면\,	면,
 면서 	면서 
 滅毛	 絨毛
 滅치	 鍼치
 몇게 한	 멎게 한
 모 두	 모두
 모 르	 모르
 모 순	 모순
 모 양	 모양
 목 적	 목적
 몰 랐	 몰랐
 무 시	 무시
 무를	 무릎
 무름	 무릎
 문 제	 문제
 물 질	 물질
 므로	므로
 미 치	 미치
 未瀉	 未潰
 蜜塞	 壅塞
 蜜葉	 莖葉
 蜜滯	 壅滯
 및 게 한	 멎게 한
 바 꾸	 바꾸
 반 면	 반면
 반 해	 반해
 攀로	 鬱로
 발 병	 발병
 발 생	 발생
 發疼	 發疹
 發疫	 發疹
 方	一方
 방 지	 방지
 膀上	 臍上
 膀下	 臍下
 배 가 	 배가 
 배 뇨	 배뇨
 배 려	 배려
 배 열	 배열
 배 오	 배오
 배 출	 배출
 白 朮 	 白朮 
 변 증	 변증
 變證	 鬱證
 병 변	 병변
 병 용	 병용
 병 증	 병증
 病 症	 病症
 병 태	 병태
 보 면	 보면
 보 이	 보이
 보 인	 보인
 보 자	 보자
 보 하	 보하
 譜語	 譫語
 복 용	 복용
 腹 證	 腹證
 腹 痛	 腹痛
 복용 하	 복용하
 福皮	 橘皮
 본 방	 본방
 不 	 不
 不 利	 不利
 부 어	 부어
 부 정	 부정
 府감	 疳감
 部는 	部는 
 부터	부터
 不喉 	 不嘔 
 분 비	 분비
 분 석	 분석
 噴氣	 噯氣
 불 명	 불명
 불 안	 불안
 비 교	 비교
 비 염	 비염
 臂曲	 彎曲
 痺痒	 痺症
 臂이	 腎이
 濱	 瀉
 빈 도	 빈도
 頻果	 蒴果
 빠 	 빠
 뻐 근	 뻐근
 뻬	 빼
 쁜	쁜
 사 라	 사라
 사 람	 사람
 사 실	 사실
 사 용	 사용
 사 이	 사이
 사 탐	 사람
 사 탐은	 사람은
 사\^하	 사용하
 四瀉	 四瀆
 瀉髓	 薦髓
 사통하	 사용하
 살 아	 살아
 상 당	 상당
 상 반	 상반
 상 태	 상태
 上窟	 上竄
 上臂	 上脣
 생 각	 생각
 생 활	 생활
 서 양	 서양
 서 양의학	 서양의학
 腺說	 臆說
 설 명	 설명
 설 사	 설사
 泄清	 泄瀉
 성 격	 성격
 성 질	 성질
 誠\,	 鍼,
 誠과	 鍼과
 誠으	 鍼으
 誠을	 鍼을
 誠의	 鍼의
 誠이	 鍼이
 성인 병	 성인병
 소 개	 소개
 소 견	 소견
 소 리	 소리
 소 실	 소실
 소 화	 소화
 小勝	 小腸
 소청통	소청룡
 屬	屬
 속 도	 속도
 속 이 	 속이 
 수 없이 많	 수없이 많
 수록 	수록 
 瘦脈	 瘈脈
 垂葉	 莖葉
 瘦症	 痺症
 순 환	 순환
 스러	스러
 스러운	스러운
 스럽	스럽
 시 간	 시간
 시 기	 시기
 시 작	 시작
 시실	 사실
 시켜	시켜
 시키	시키
 식 사	 식사
 식 후	 식후
 식시	 식사
 식채	 식체
 신 경정신	 신경정신
 신 장	 신장
 실 시한	 실시한
 실 제	 실제
 心 身證	 心身證
 심 하	 심하
 心 下	 心下
 심 하게	 심하게
 심 해	 심해
 써\,	써,
 씩 	씩 
 아 주	 아주
 아직 도 	 아직도 
 안 \^다\.	 안 된다.
 앉 	 앉
 않 	 않
 알 아	 알아
 癌狂	 癲狂
 癌瘤	 癲癎
 았	았
 았다	았다
 也	也
 야 간 	 야간 
 약 간	 약간
 얄게	 얕게
 痒症	 痺症
 痒痛	 痺痛
 어 혈	 어혈
 얽은 	 엷은 
 掩A	 攙入
 없 	 없
 었	었
 었다	었다
 에 	에 
 에게	에게
 에게 	에게 
 에는	에는
 에대	에 대
 에도 	에도 
 에서	에서
 여 기	 여기
 여 부	 여 부
 여 성	 여성
 연 약	 연약
 열게 잔	 옅게 잔
 염\,	염,
 葉膝	 葉腋
 葉胶	 葉腋
 였	였
 였다	였다
 英果	 莢果
 營熱	 鬱熱
 오 르	 오르
 오 행	 오행
 와 	와 
 와 병용	와 병용
 와는	와는
 완 성	 완성
 외 회전	 외회전
 요 구	 요구
 요 소	 요소
 요 통	 요통
 우 리	 우리
 원 인	 원인
 원 칙	 원칙
 월 경	 월경
 웬지	 왠지
 위 해 	 위해 
 유 사	 유사
 유 지	 유지
 유 효	 유효
 有 效	 有效
 癒瘤	 癲癎
 癒證	 癲證
 儒하	 濡하
 愈穴	 兪穴
 癒痕	 癥瘕
 으로	으로
 으로 	으로 
 으며	으며
 은 	은 
 銀齒	 鋸齒
 을 	을 
 을 둔	을 둔
 飮 水	 飮水
 陰德脈	 陰蹻脈
 陰瘦	 陰痿
 응 용	 응용
 의 	의 
 의 문을 	 의문을
 의 해 	 의해 
 醫氣	 腎氣
 의시는	 의사는
 의측	 외측
 意했	 薏苡
 이 	이 
 이 나타	이 나타
 이 뇨	 이뇨
 이 동	 이동
 이 되어	이 되어
 이 때	 이때
 이 뚜	이 뚜
 이 런	 이런
 이 로	 이로
 이 야기	 이야기
 이 없	이 없
 이 용	 이용
 이 있	이 있
 이 제는	 이제는
 이 좋	이 좋
 이 포함	이 포함
 이 해하	 이해하
 이고 	이고 
 이나	이나
 이나 	이나 
 이다\.	이다.
 이때문	 이 때문
 이라 	이라 
 이라고 	이라고 
 이를 동안	 이틀 동안
 이며	이며
 이며 	이며 
 이므	이므
 이었	이었
 이었다	이었다
 이주 	 아주 
 익들	 약들
 인 격	 인격
 인 식	 인식
 인 체	 인체
 인 한 	 인한 
 인 해	 인해
 인 해	 인 해
 因性	因性
 人革	 人蔘
 일 리	 일리
 일 반	 일반
 일 반적	 일반적
 일 본	 일본
 일 어	 일어
 일 으	 일으
 일 정	 일정
 일 정하	 일정하
 임 신	 임신
 입니	입니
 자 신	 자신
 자 주	 자주
 者\,	者,
 雌蔬	 雌蕊
 작 용	 작용
 嚼乾	 嗌乾
 잘 못된	 잘못된
 장 애	 장애
 腸關	 膈關
 腸俞	 膈俞
 腸應	 腸癰
 腸痛	 腸癰
 張하	 脹하
 재 발	재발
 적 	적 
 贼 	 鹹 
 적 용	 적용
 적 응	 적응
 적 지	 적지
 적 합	 적합
 적\,	적,
 赤病	 赤痢
 的으	的으
 적으로	적으로
 的인	的인
 적인 	적인 
 전 신	 전신
 절 대	 절대
 粘疲	 粘痰
 접적	접적
 정 도	 정도
 정 리	정리
 정 맥	 정맥
 정 신	 정신
 政量	 眩暈
 제 거	 제거
 조 금	 조금
 조 절	 조절
 族生	 蔟生
 腫療	 腫瘍
 腫腹	 腫脹
 腫傷	 腫瘍
 腫臭	 腥臭
 좋 	 좋
 좋은	 좋은 
 좋은  	 좋은 
 주 요	 주요
 주 의	 주의
 主 하	 主하
 줄 기	 줄기
 중 심	 중심
 中嘔	 中暍
 中濱	 中瀆
 中助	 中肋
 中淸	 中渚
 즐면 	 줄면 
 증 명	 증명
 증 상	 증상
 증\,	증,
 症\,	症,
 之	之
 지 금	 지금
 지 나	 지나
 지 름 	 지름 
 지 않	지 않
 지 않은	지 않은
 지와면서	 자라면서
 지이\"	 자아
 지주 	 자주 
 稷	 稜
 稷角	 稜角
 診 	診 
 진 정	 진정
 진 해	 진해
 쪽	쪽
 쪽 	쪽 
 차 이	 차이
 참쌀	 찹쌀
 瘡疾	 瘧疾
 瘡疾\,	 瘧疾,
 처럼 	처럼 
 凄弱	 痿弱
 天腸	 天牖
 청 소년	 청소년
 체 질	 체질
 촬熱	 鬱熱
 출 혈	 출혈
 취 	 취
 치 료	 치료
 치투	 치루
 타 서	 타서
 奪毛	 茸毛
 湯\,	湯,
 太絡	 太谿
 痛\, 狂	 癲, 狂
 痛悸	 痛痺
 痛에	 癲에
 痛은 心血不足	 癲은 心血不足
 통종	 통증
 痛證\,	 癲證,
 투 여	 투여
 툭 이	 특이
 특 	 툭 
 특 색	 특색
 판한 	 관한 
 팬찮	 괜찮
 팬히	 괜히
 篇	篇
 篇』	篇』
 평 소	 평소
 폐 색	 폐색
 蔽生	 腋生
 肺癒	 肺癰
 蔽腫	 腋腫
 肺痛	 肺癰
 포 함	 포함
 褒蠻	 痰鬱
 褒이	 痰이
 幅도	 嘔도
 疲과	 痰과
 피로 해	 피로해
 疲을	 痰을
 疲이	 痰이
 하 고	 하고
 하 나	 하나
 하 는	 하는
 하 루	 하루
 하 복	 하복
 下 腹	 下腹
 하 여	 하여
 하 지	 하지
 하게 	하게 
 하고\,	하고,
 하는 작용	하는 작용
 하다\.	하다.
 下臂	 下脣
 하여 	하여 
 한 것	한 것
 한 다	 한다
 한 방약	 한방약
 한 방을	 한방을
 한 방제제	 한방제제
 한다\.	한다.
 한의 학	 한의학
 한잔	 한 잔
 할 수 	할 수 
 항 생제	항생제
 행구	 헹구
 허 약	 허약
 弦量	 眩暈
 賢뿐	 腎뿐
 賢에	 腎에
 賢을	 腎을
 賢이	 腎이
 혈 관	 혈관
 혈 압	 혈압
 혈 전	 혈전
 俠絡	 俠谿
 호 전	 호전
 혹 은 	 혹은 
 홀러	 흘러
 홀리	 흘리
 홑어	 흩어
 化膽	 化膿
 花蜜	 花莖
 花奮	 花蕾
 花塞	 花莖
 화藥	 芍藥
 환 지	 환자
 歡症	 鬱症
 환지	 환자
 黃等	 黃芩
 黃藥	 黃蘗
 黃흑	 黃芩
 회 	회 
 횐	 흰
 효 과	 효과
 효과 적	 효과적
 胶生	 腋生
 喉疼	 喉痺
 後絡	 後谿
 훅은 	 혹은 
 胸 滿	 胸滿
 痕氣	 痰氣
 痕瘡	 痘瘡
 히 	히 
 힘 이	 힘이
！1徊虫	蛔蟲
!寫	瀉
！响蟲	蛔蟲
！响虫	蛔蟲
"區	嘔
#門冬	麥門冬
#삭돌	축삭돌
\)濟	臍
\*敦	大敦
\*裏	大棗
\*裏湯	大棗湯
\*成	大成
\*烏頭	大烏頭
\*腸	大腸
\*腸炎	大腸炎
\*椎	大椎
\*便	大便
\*便 	大便 
\*汗	大汗
、	, 
。	. 
：	: 
:  	: 
;!	瀉
;1心	瀉心
;B心	瀉心
；t 甘	朮甘
;令	冷
；令	冷
；寫	瀉
;寫	瀉
;易	湯
;湯	湯
？	?
@盲	回盲
'@盲	回盲
^'	‘
\{	(
\}寫	瀉
~ 	~
’ 고 	’고 
’ 라	’라
’ 라 	’라 
’ 라고	’라고
’ 은 	’은 
’ 이	’이
’ 이라	’이라
’ 이란	’이란
’ 하는 	’하는 
’•甘藍味辛!仁i	苓甘薑味辛夏仁湯
’는	’는 
“ 	 “
“區	嘔
”고했	”고 했
「 	「
「上古天眞	『上古天眞
」등	」 등
『腦內革命J	『腦內革命』
【목표\.	【목표】
\"이라	”이라
\( 「 	(「
\(古方®	(古方派)
\(祉\)	(趾)
\(賢	(腎
\)!!候	腹候
\)’寫	瀉
\)s黃劑	麻黃劑
\)恍	胱
\*戟	大戟
\*棄	大棗
\*氣	大氣
\*道	大道
\*豆	大豆
\*豆黃	大豆黃
\*方	大方
\*補	大補
\*小	大小
\*柴胡	大柴胡
\*著	黄耆
\*劑	大劑
\*主	大主
\*靑葉	大靑葉
\*阪	大阪
\*學	大學
\*寒	大寒
\*黃	大黃
\*黃甘草	大黃甘草
\,	, 
\, 라고	’라고
\, 賢	, 腎
\,\(	, (
\,라는 	’라는 
\,로	’로
\,으로	’으로
\.\.\.	…
\/v夢	人蔘
\?桂	苓桂
\^•§•체	수용체
\^였다	하였다
\^용체	수용체
\^ᅡ	사
\{水毒\)	(水毒)
\|\|	|
\-\>	→
\-\-其	一其
\-\-端	一端
\+味敗	十味敗
\+全大	十全大
\<古方®	(古方派)
\<心下\)	(心下)
\<寒\)	(寒)
\>1•	유아
\-II	#NAME?
'\I忽	惚
\l40	140
\lOO	100
\t\t보麥ᄎ	甘麥大
\-貫 堂	一貫堂
\-貫堂	一貫堂
«區	嘔
»區	嘔
»上择	臍上悸
□	口
□渴	口渴
□苦	口苦
□鼻	口鼻
□舌	口舌
□瘡	口瘡
□齒	口齒
□ᅡ	마
◦일	0일
→ 名	一名
®損	虧損
°C	℃
•	·
0客	喀
0區	嘔
0嘔	嘔
0君子	四君子
①	① 
⑴	-1
1 療	1療
①\t	① 
1◦	10
11區	嘔
11歲	噦
11胃承氣	調胃承氣
1季	悸
1方纖	漢方槪論
1한방의학’	‘한방의학’
②	② 
⑵	-2
②\t	② 
③	③ 
⑶	-3
③\t	③ 
3◦年	30年
④	④ 
⑷	-4
④\t	④ 
4실	사실
⑤	⑤ 
⑤\t	⑤ 
5병杏仁	茯苓杏仁
5쟎飮	茯苓飮
5肖	硝
⑥	⑥ 
⑥\t	⑥ 
6==	6==
⑦	⑦ 
7 ᅡ	가
7\]슴	가슴
7\]눙	가능
7\]능	가능
7\]능해	가능해
7\>족	가족
⑦\t	⑦ 
7==	7==
71능	가능
71루	가루
71부장	가부장
71슴	가슴
7fc	朮
7ft	朮
7ft甘	朮甘
7ᅵ분	기분
⑧	⑧ 
⑧\t	⑧ 
80\-90	80~90
8S上洋	臍上悸
8S上择	臍上悸
8씩	g씩
8을	g을
⑨	⑨ 
⑨\t	⑨ 
⑩	⑩ 
⑩\t	⑩ 
Ⅰ형	I형
ⅡI	Ⅲ
A 夢	人蔘
A 性	人性
A 中	人中
A 體	人體
A1 냅스	시냅스
Af상	사상
Af용	사용
a經活血	疎經活血
A夢	人蔘
A門	入門
A民	人民
A事	人事
A性	人性
A身	人身
A於	入於
A迎	人迎
A絶	人絶
A中	人中
A體	人體
BI下	臍下
BS上择	臍上悸
BT氣	肝氣
B區	嘔
D 區	嘔
〜dence	evidence
d區	嘔
D亞	啞
eg◦	ego
ffi	疝
ffi上If	臍上悸
ffi儀	巫儀
ffi症	疝症
ffi痛	澁痛
ffi痛	疝痛
ffi血	補血
ffl醫	巫醫
fH冬湯	麥門冬湯
fS杏甘石	麻杏甘石
f客	喀
f季	悸
GP Ib	GPⅠb
GP Ilb	GP Ⅱb
HZ	Hz
H下择	臍下悸
I!白皮	桑白皮
I~II	Ⅰ~Ⅱ
IⅠ군	Ⅱ군
ICD\-lO	ICD-10
II 수용체	Ⅱ 수용체
III	Ⅲ
III\-IV	Ⅲ~Ⅳ
III형	Ⅲ형
II형	Ⅱ형 
'I季	悸
i丘墟	丘墟
I군	Ⅰ군
i念	捻
I命	論
I法	祛
i寫	瀉
I生	性
I燕	嚥
I咸	鍼
I형	Ⅰ형
Jtt	朮
j念	捻
j法	祛
j寫	瀉
J恍	胱
K 上择	臍上悸
K門	肛門
K上择	臍上悸
lcm	1cm
lg	1g
lOO	100
m!	ml
m中益氣	補中益氣
m杏甘石	麻杏甘石
mᅵ	ml
n客	喀
n區	嘔
o10g	olog
of무	아무
P 渴	口渴
P 眼	口眼
P渴	口渴
P客疲	喀痰
P乾	口乾
P苦	口苦
P嘔	嘔
P舌	口舌
P眼	口眼
P瘡	口瘡
r 內景篇」	「內景篇」
r 外形篇」	「外形篇」
r 雜病篇」	「雜病篇」
r 증후편」	「증후편」
r 風病諸候	『風病諸候
r四氣調神	『四氣調神
r上古天	『上古天
R上洋	臍上悸
r宣明五氣	『宣明五氣
r陰陽應象	『陰陽應象
r증후편」	「증후편」
r치료편」	「치료편」
R澤	尺澤
S 甘草湯	炙甘草湯
SM\-IV	SM-Ⅳ
SM\-\-IV	SM-Ⅳ
symb이	symbol
S方	古方
s上梓	臍上悸
S心湯	瀉心湯
S枝	桂枝
Tfc	朮
Tffc	朮
tig정선	신경정신
Tit	朮
Tlfc	朮
TNF\-a	TNF-α
Ttt	朮
Ttt甘	朮甘
Ttt湯	朮湯
type II	type Ⅱ
t季	悸
t正仲	怔忡
u嘔	嘔
Wdence	evidence
W上 1f	臍上悸
W上偉	臍上悸
w上择	臍上悸
y 글로불린	γ글로불린
y\-GTP	γ-GTP
y글로불린	γ글로불린
加 Jtt 附	加朮附
가 능	 가능
가 락	가락
가 루	가루
가 리	가리
가 슴	 가슴
가 운데	가운데
가 장 	 가장 
가 지 	가지 
加;1t 附	加朮附
加;itt 湯	加朮湯
嘉祛	嘉祐
加求湯	加朮湯
가날프	가냘프
가되	가 되
가되고	가 되고
가되는	가 되는
가된	가 된
가된다	가 된다
가들	가 들
가들어	가 들어
加龙湯	加朮湯
가많	가 많
가매우	가 매우 
加味通通	加味逍遙
가부족	가 부족
가분명	가 분명
假石膏	煆石膏
가아프	가 아프
가야할	가야 할
가없	가 없
가요구	가 요구
가운 데	가운데
가운넷	가운뎃
가움	가 움
가이 	가 이 
가있	가 있
가잘	가 잘
가존재	가 존재
가좋	가 좋
가중요	가 중요
가튀	가 튀
가특징	가 특징
가포함	가 포함
각 종 	각 종 
覺癒瘦	覺痲痺
各仁	杏仁
角條	魚際
각중상	각증상
角賛皮	角贅皮
肝 實	肝實
간 염	간염
간 장	간장
癎癎	癲癎
간것	간 것
간경 화	간경화
肝戀	肝鬱
肝蠻	肝鬱
肝蜜	肝鬱
谏蜜	煉蜜
肝攀	肝鬱
肝臂	肝腎
肝醫	肝腎
肝賢	肝腎
肝效	肝欬
喝	嘔
갈 비	갈비
갈 수록	갈수록
갈 증	갈증
갈수	갈 수
减	減
감 각	감각
감 소	감소
감 정	감정
減灸	鍼灸
甘舊味	甘薑味
敢權	甄權
感胃	感冒
甘草끓	甘草湯
감초팅	감초탕
갑 골	갑골
갑 자	갑자
갔 	갔
講諫	講諦
降獨	降濁
講妄	譫妄
綱胃	調胃
姜縮	萎縮
僵霞	僵蠶
降下港	降下湯
綱血	調血
姜黃	萎黃
갖 	갖
같 	같
같은 쪽	같은쪽
같은쪽	같은 쪽
皆 屬	皆屬
개 요	개요
開 花	開花
開穀	開竅
開關通發	開關通竅
開窮	開竅
開閨	開闔
開閨福	開闔樞
皆履	皆屬
開蠻	開鬱
開敷	開竅
객 	객
客许	客忤
舉	擧
거 나	거나
거 나 	거나 
거 리	거리
거 림	거림
거 운	거운
居硬	痞硬
去穀	去殼
据구	梔子
居滿	痞滿
去浮	去滓
柜葉	栢葉
祛癒	祛瘀
据子	梔子
巨闘	巨闕
祛蔽	祛瘀
去疲	去痰
祛疲	祛痰
居骸	居髎
巨骸	巨髎
鍵	腱
건 강	건강
건 망	건망
健 忘	健忘
건 져	건져
건 중탕	건중탕
건&탕	건강탕
乾«湯	乾薑湯
乾■湯	乾薑湯
乾薑易	乾薑湯
乾舊	乾薑
腱灸	鍼灸
乾臺	乾薑
乾童	乾薑
乾藍	乾薑
乾藍湯	乾薑湯
乾蓮	乾薑
乾蓮渴	乾薑湯
乾蔓	乾薑
乾墓	乾薑
건밍	건망
乾蕃	乾薑
乾塞湯	乾薑湯
乾甚	乾薑
乾養	乾薑
건중 탕	건중탕
乾重附子	乾薑附子
建中游	建中湯
建中淸	建中湯
乾唱	乾嘔
乾蓄	乾薑
乾幅	乾嘔
乾畫	乾薑
걸 리	걸리
걸쪽	걸쭉
检	栓
검 사	검사
檢子	梔子
檢轉	捻轉
臉左	臍左
臉下	臍下
臉穴	腧穴
것 과	것과
것 도	것도
것 만	것만
것 보다	것보다
것 으	것으
것 을	것을
것 이	것이
것 인	것인
것 일	것일
것 임	것임
것 입	것입
것 처	것처
것\s+들	것들
것같	것 같
것같이	것 같이 
게 는	게는
揭 色	褐色
게되	게 되
게된	게 된
게된 	게 된 
게만	게 만
憩白	蔥白
揭色	褐色
게하	게 하
게한	게 한
게한다	게 한다
게할 	게 할 
게해	게 해
揭紅	褐紅
揭黃	褐黃
揭灰	褐灰
揭黑	褐黑
겠 	겠
겨 져	겨져
隔俞	膈俞
擊痛	掣痛
견 갑	견갑
見A	見人
견다	견디
肩騰	肩臑
肩髓	肩髃
肩狎	肩胛
遣遙散	逍遙散
肩隅	肩髃
肩肿	肩胛
肩骸	肩髎
결 과	결과
결 국	결국
결 론	결론
結 實	結實
결 절	결절
結梗	桔梗
結梗湯	桔梗湯
結於脾	結於髀
結痴	結痂
缺風	祛風
겼 	겼
경 계	경계
경 골	경골
經 絡	經絡
경 맥	경맥
經 脈	經脈
梗 米	粳米
경 사	경사
경 우	경우
경 우에	경우에
경 추	경추
경 향	경향
경 험	경험
경 혈	경혈
經 穴	經穴
경 화	경화
硬 化	硬化
經!\^說	經絡學說
擎急	攣急
慶끓	慶熙
驚惊	驚悸
驚瘤	驚癎
梗米	粳米
經發痺	經發揮
驚腹	鱉腹
驚俘	驚悸
경불 순	경불순
擎引	攣引
驚淨	驚悸
驚择	驚悸
經疲眩	脛痠眩
頃弦	瞑眩
驚懐	驚悸
계 속	계속
계 지탕	계지탕
계 통	계통
계 피	계피
桂梗	桔梗
桂舊裏	桂薑棗
계내 금	계내금
械毛	絨毛
悸庭	椿庭
계지 탕	계지탕
桂枝5병丸	桂枝茯苓丸
桂枝膀丸	桂枝茯苓丸
계지복 령환	계지복령환
桂枝碑丸	桂枝茯苓丸
桂枝易	桂枝湯
桂枝淸	桂枝湯
桂枝海	桂枝湯
계择	계悸
桂형	桂芍
库	痺
库	痒
고 \^다\.	고 있다.
고 려	고려
고 플	고플
고 하 \^다	고 하였다
古A	古人
苦is	苦滿
庫角	犀角
枯梗	桔梗
고기술	고 기술
고기자	구기자
고끊	고 끊
고나서	고 나서
고달여	고 달여
顧倒	顚倒
고도한다	고도 한다
고려 한	고려한
苦流	苦澁
鼓膜	鼓脹
膏盲	膏肓
苦夢	苦蔘
고방 파	고방파
고본다	고 본다
고생각	고 생각
顧損	虧損
顧息	顱息
고식 염	고식염
고앉	고 앉
고알려	고 알려
고여겨	고 여겨
雇亏	虧
膏育	膏肓
鼓陰	竅陰
고이 	고 이 
고있	고 있
고있다	고 있다
鼓張	鼓脹
苦贼	苦鹹
고적용	고 적용
庫瘡	癉瘧
搞瘡	瘑瘡
고치료	고 치료
庫痛	癉瘧
库痛	痺痛
枯風	祛風
고하였	고 하였
苦喊	苦鹹
고했	고 했
辜丸	睾丸
顧會	顖會
鼓懐	鼓慄
고ᅡ	과
고ㅏ	과
曲類	曲頰
穀陰	竅陰
穀張	穀脹
棍	樞
곤 란	곤란
棍子	梔子
곤한다	곤 한다
골 격	골격
골 관절	골관절
골 근	골근
골 반	골반
骨 蒸	骨蒸
骨库	骨痺
骨絲	骨繇
骨嵩	骨窩
骨痒	骨痺
곰 팡이	곰팡이
곰광이	곰팡이
供 乾	烘乾
공 격	공격
供乾	烘乾
과 도 	과도 
과 민성	과민성
果 實	果實
과 학의 	과학의 
과같	과 같
과관련	과 관련
瓜囊	瓜蔞
과다리	과 다리
瓜茶	瓜蔕
과로 하	과로하
瓜寞	瓜蔞
과배합	과 배합
과손가	과 손가
瓜養	瓜蔞
과어깨	과 어깨
過遙散	逍遙散
瓜雲	瓜蔞
과유사	과 유사
瓜藉	瓜蔕
瓜奠	瓜蔞
過充	過亢
鍋齒	鋸齒
과치료	과 치료
과투인	과루인
瓜辦	瓜瓣
과함께	과 함께
藿亂	霍亂
霍麥	瞿麥
霍香	藿香
관 계	관계
관 련	관련
關 元	關元
관 절	관절
關 節	關節
관 점	관점
관 찰	관찰
棺梗	桔梗
關窮	關竅
棺堂	榕堂
관람근	판람근
貫時	貫肘
寬옮	崑崙
貫腸	貫膈
寬斋	崑崙
寛斋	崑崙
觀體	顴髎
觀骸	顴髎
觀紅	顴紅
括樓	栝樓
括莫	括蔞
括養	括蔞
框	樞
狂A	狂人
框子	梔子
괴롭하	괴롭히
壞痕	壞疽
膠始	膠飴
膠餘	膠飴
橋圓	橢圓
膠刺	繆刺
柩	樞
惧	惕
구 균	구균
口 襟	口噤
구 부	구부
구 성	구성
구 역	구역
구 조	구조
口!음	마음
口！음	마음
拘«	拘«
拘«	拘攣
求甘	朮甘
求甘湯	朮甘湯
拘擎	拘攣
舊桂	薑桂
口區	嘔
龜溝	蠡溝
구宮	子宮
苟歸	芎歸
口襟	口噤
丘疼	丘疹
久铜	久痢
夠藤	鉤藤
구良	子良
拘攀	拘攣
口臂	口脣
嘔斜	喎斜
拘祀	枸杞
构祀	枸杞
溝上	淸上
口亞	啞
苟藥	芍藥
嘔嚷	嘔噦
區逆	嘔逆
構圓	橢圓
溝陰	濁陰
口醫	口脣
口脊	口脣
久清	久瀉
口層	口脣
區吐	嘔吐
苟片	苞片
溝肺	淸肺
購下	臍下
躯	軀
钩	鉤
君구	君子
君子；«	君子湯
君子淸	君子湯
君子港	君子湯
굴 곡	굴곡
굴 근	굴근
窟悶	痞悶
굽하	굽히
宫	宮
窮陰	竅陰
권 한	권한
权實	枳實
權圓	橢圓
捲溺	搐搦
拳丸	睾丸
權患	罹患
厥 陰	厥陰
轨	鼽
궤 양	궤양
貴門	賁門
窺	竅
窥	竅
菌끓萬	茵蔯蒿
菌표萬	茵蔯蒿
橘圓	橢圓
그 것	그것
그 녀	그녀
그 대로	그대로
그 래	그래
그 램	그램
그 러	그러
그 런	그런
그 릇	그릇
그 리고	그리고
그기자	구기자
그다음	그 다음 
그러 나	그러나
그런 데	그런데
그요지	그 요지
그이상	그 이상
극 단	극단
극 하	극하
極子	梔子
謹	證
근 골	근골
근 본	근본
근 육	근육
筋t易	筋惕
筋惧	筋惕
筋攀	筋攣
筋瘦	筋痿
根室	根莖
根實	枳實
根藉	根@@蒂
根菜	根莖
筋懐	筋惕
금 궤요략	금궤요략
襟0	噤口
금궤 요략	금궤요략
禁滅	禁鍼
擒挫	捻挫
錦齒	鋸齒
急 方	急方
給A	給人
急後M	急後重
其 	其
機 	機
기 \.혈•수	기•혈•수
기 계	기계
기 관	기관
기 능	기능
機 能	機能
氣 攀	氣鬱
기 억	기억
기 운	기운
氣 滯	氣滯
기 초	기초
기 침	기침
氣 虛	氣虛
氣 血•水	氣•血•水
기\(M\)	기(氣)
기관 지	기관지
肌紐	肌衄
기도하다\.	기도 하다.
기도한다	기도 한다
기도했	기도 했
기때	기 때
氣戀	氣鬱
기록 한	기록한
氣蠻	氣鬱
氣攀	氣鬱
氣變\,	氣鬱,
棄賦	稟賦
기어렵	기 어렵
기역\(氣왠	기역(氣逆
기와혈	기와 혈
기울\(氣蜜	기울(氣鬱
기울\(氣變	기울(氣鬱
機圓	橢圓
嗜雜	嘈雜
嗜腸	噎膈
氣懲	氣鬱
기허 M	기허氣虛
기허tui	기허氣虛
긱혜	각해
긴 장	긴장
긴장 되	긴장되
길 이	길이
길 항	길항
洁梗	桔梗
金\[賣	金匱
金a要	金匱要
金B要	金匱要
金K	金匱
金K要	金匱要
金R要	金匱要
金S	金匱
金概要	金匱要
金匿	金匱
金匿要	金匱要
金匪要	金匱要
金箱	金箔
金圓要	金匱要
金隱要	金匱要
金置	金匱
金置 要略	金匱要略
金置要	金匱要
金置要略	金匱要略
깅하	강하
까 지	까지
깨 끗	깨끗
꺼 기	꺼기
껍 질	껍질
꼽하	꼽히
꿇	끓
꿈 치	꿈치
끄 럽	끄럽
끊 	끊
끓 	끓
끓여먹	끓여 먹
끓證	湯證
끓合	湯合
끼 는	끼는
낌질	찜질
ᄂev	Lev
나 는 	나는 
나 타나	나타나
나H로	나므로
나누 어	나누어
나다리	나 다리
나라각지	나라 각지
나타 \^다\.	나타난다.
나타 난	나타난
나타니	나타나
나혹은	나 혹은 
난 다\.	난다.
暖氣	噯氣
날수	날 수
남 성	남성
났 	났
娘娠	姙娠
낮 	낮
内	內
내 게	내게
내 과비록	내과비록
內 服	內服
내 어 	내어 
내 용	내용
내 측	내측
內谏	內煉
內皆	內眥
內课	內踝
내담 자	내담자
內滅	內鍼
內普	內眥
내쁨	내뿜
內碟	內踝
內誠	內鍼
內癒	內癰
內躁	內踝
낸다음	낸 다음
냄 비	냄비
냈 	냈
냉;\^	냉冷
너 지	너지
넓 	넓
넓적 다리	넓적다리
넘 어	넘어
넣 	넣
네폐질	네페질
넷가	냇가
年 老	年老
捻轉	捻轉
寧藤	葶藶
寧歷	葶藶
寧歴	葶藶
寧薩	葶藶
노 력	노력
노夢	人蔘
노창\(怒膨	노창(怒脹)
노ᅵ	뇌
녹간	늑간
논 리	논리
논 의하	논의하
濃已成	膿已成
높 	높
높 아	높아
높 이	높이
놓 	놓
脑	臍
腦 髓	腦髓
腦窮	腦竅
脑下	臍下
뇌하\^체	뇌하수체
尿獨	尿濁
누 르	누르
누 른	누른
누 어 	누어 
嫩水	漱水
눌수있	눌 수 있
뉴 런	뉴런
紐血	衄血
늄枝	桂枝乾
느 끼	느끼
느 낌	느낌
느 냐	느냐
느쪽	느 쪽
는 가 	는가 
는 가\.	는가.
는 가\?	는가?
는 가가	는가가
는 가를	는가를
는 가에	는가에
는 가이다	는가이다
는 다는	는다는
는 지 	는지 
는 지\,	는지,
는것	는 것
는게	는 게
는게 	는 게 
는게 아	는 게 아
는경	는 경
는곳	는 곳
는그	는 그
는근거	는 근거
는근육	는 근육
는금	는 금
는기	는 기
는내	는 내
는느낌	는 느낌
는능력	는 능력
는다르	는 다르
는다른	는 다른
는다시	는 다시
는다음	는 다음
는데 사용	는 데 사용
는데 중요	는 데 중요
는데는	는 데는
는데도 좋	는 데도 좋
는데이	는데 이
는동	는 동
는듯	는 듯
는등	는 등
는뜻	는 뜻
는말	는 말
는모	는 모
는무	는 무
는물	는 물
는방	는 방
는방제	는 방제
는병	는 병
는복	는 복
는부	는 부
는부위	는 부위
는사	는 사
는상	는 상
는설	는 설
는소	는 소
는소리	는 소리
는손	는 손
는수	는 수
는안	는 안
는않	는 않
는약	는 약
는어	는 어
는없	는 없
는여	는 여
는용	는 용
는운동	는 운동
는원인	는 원인
는음	는 음
는의미	는 의미
는이 	는 이 
는일	는 일
는자	는 자
는작 	는 작
는작용	는 작용
는점	는 점
는정	는 정
는좋	는 좋
는症	는 症
는증상	는 증상
는증후	는 증후
는질병	는 질병
는쪽	는 쪽
는처	는 처
는통	는 통
는특	는 특
는할	는 할
는형	는 형
는환자	는 환자
는효	는 효
늘 어	늘어
능 력	능력
능 성	능성
呢	呃
니 까	니까
니 다	니다
니 라	니라
니 트로	니트로
니누	나누
呢逆	呃逆
니이\" 가	나아가
니이•	나아
溺	溺
다 고 	다고 
다 는 	다는 
다 란	다란
다 른	다른
다 리	다리
다 면 	다면 
다 시 	다시 
다 음	다음
다 음 	 다음 
다 투	다투
다\, 라고 	다'라고 
다’고 	다"고 
다’라고	다"라고
다”	다.”
다\-	다.
다\, 고 	다’고 
다\,는	다’는 
다\^	다.
다■	다.
다고되	다고 되
다고한다	다고 한다
다고할 	다고 할 
다고했	다고 했
다끓	다 끓
다는	다는 
다른손	다른 손
다른쪽	다른 쪽
다면이 	다면 이 
다음과 \^다	다음과 같다
다좋	다 좋
茶甘	苓甘
茶甘■味	苓甘薑味
茶甘蓮味	苓甘薑味
茶桂	苓桂
多蠻	多鬱
茶墓朮	苓薑朮
단 계	단계
단 단	단단
단 독	단독
斷 面	斷面
단 순	단순
단 축	단축
蛋休	蚤休
달 걀	달걀
달 리	달리
달여 서 	달여서 
달여먹	달여 먹
달인물	달인 물
담 갔	담갔
담 당	담당
담\(疲\)	담(痰)
담궜	담갔
擔擔	澹澹
痰獨	痰濁
痰桐	痰稠
膽妄	譫妄
膽未成	膿未成
膽攀	膽礬
膽傷	膿瘍
膽語	譫語
膽의 흡수	膿의 흡수
膽汁港	膽汁湯
담疲	담痰
膽血	膿血
답 답	답답
答桂朮	苓桂朮
踏脈	蹻脈
당 귀	당귀
당 뇨	당뇨
당 량	당량
당 신	당신
당 연	당연
당귀 작약산	당귀작약산
당뇨 병	당뇨병
當 歸	當歸
當\^芍藥	當歸芍藥
唐®仁湯	木防己湯
當fS	當歸
當fS芍藥	當歸芍藥
撞库	搔痒
當歸芍藥	當fS芍藥
党端	兌端
糖上择	臍上悸
當腺	當腑
塘泄	溏泄
糖圓	橢圓
黨參	黨蔘
黨黑	黧黑
대 개	대개
對 句	對句
大 敦	大敦
대 부	대부
大 小	大小
大 腸	大腸
대 조	대조
대 쪽	대쪽
대 퇴	대퇴
대 표	대표
대 한	대한
대 해	대해
大:便	大便
大\*牡丹皮	大黃牡丹皮
大ff	大杼
대개이	대개 이
臺格堂	臺榕堂
大轰	大棗
大棄	大棗
大裏	大棗
大裏湯	大棗湯
대맥\(帶M	대맥(帶脈
大保敬	大塚敬
大補황	大補湯
代緒石	代赭石
大勝經	大腸經
대이 	대 이 
大齋湯	大棗湯
大秦	大棗
大\-秦	大棗
대추2	대추 2
대湯\)	대황)
대틔	대퇴
대표 적	대표적
大行	大杼
代赫	代赭
大黃®蟲	大黃蟅蟲
대황大\*	대황大黃
大黃港	大黃湯
大黃黃	大黃
대흐	대추
더 불	더불
더 불어	더불어
더 욱	더욱
더부록	더부룩
德法	瀉法
德狀	穗狀
德心湯	瀉心湯
德轉	捻轉
던 져	던져
던증	던 증
덧 붙	 덧붙
덮 	덮
데이 	데 이 
데이 터	데이터
뎨 지 	계지
뎨지	계지
涛	瀉
涛	痔
도 \^다\.	도 한다.
導 氣	導氣
도 띠와	도 따라
倒 卵	倒卵
도 록	도록
도 록 	도록 
도 움	도움
도 핵승기	도핵승기
道A	道人
堵茶	猪苓
도록하	도록 하
도록한다	도록 한다
涛漏	痔漏
도많	도 많
도불리	도 불리
도사용	도 사용
涛泄	瀉泄
道遙散	逍遙散
도응용	도 응용
도이 	도 이 
도있	도 있
도있다\.	도 있다.
도좋	도 좋
도중요	도 중요
涛瘡	痔瘡
萄片	苞片
도하고	도 하고
도하는	도 하는
도하였	도 하였
도한다	도 한다
도할	도 할
도할 수	도 할 수
도핵 승기	도핵승기
堵홉	猪苓
涛火	瀉火
도효과	도 효과
督 脈	督脈
獨夢	獨蔘
督悶	瞀悶
篤心湯	瀉心湯
督正格	腎正格
獨涕	濁涕
獨唾	濁唾
頓車	頰車
돌 리	돌리
돌 아	돌아
铜	痢
銅 A	銅人
동 계	동계
동 맥	동맥
動 脈	動脈
同 屬	同屬
동 안	동안
東 醫	東醫
東 醫寶	東醫寶
동 작	동작
疼 痛	疼痛
東 훌寶鑑	東醫寶鑑
東;同	東洞
東±D	東垣
銅A	銅人
動怪	動悸
董根	蘆根
動惊	動悸
동맥경 화	동맥경화
東쁠	東醫
動淨	動悸
銅疾	痢疾
铜疾	痢疾
動慘	動悸
疼聴	痄腮
動择	動悸
動懐	動悸
돼 지	돼지
되 고 	되고 
되 기도	되기도
되 는	되는
되 면	되면
되 어	되어
되 어 	되어 
되 지 	되지 
되기도한다	되기도 한다
된 다\.	된다.
된 다고	된다고
된것	된 것
된상태	된 상태
될 수록	될수록
될것	될 것
될수	될 수
두 골	두골
두 부	두부
두 중감	두중감
두 통	두통
頭 暈	頭暈
두가지	두 가지
杜螺	牡蠣
頭量	頭暈
頭嶺	頭巓
두롭	두릅
杜瑪	牡蠣
頭滅	頭鍼
肚門	肛門
두번	두 번
頭誠	頭鍼
두손	두 손
豆惹	豆蔲
頭章	頭暈
杜蝶	牡蠣
頭肢	頭眩
두틈	두툼
두팁	두텁
頭弦	頭眩
둔 근	둔근
둥 	등 
둥\)	 등)
둥\.	등.
둥근육	등근육
둥에	등에
둥의	등의
드 랍	드랍
드 러	드러
드 럽	드럽
드 리	드리
드 시	드시
드 陽	三陽
드兩	三兩
드里	三里
드物	三物
드味	三味
드服	三服
드分	三分
드升	三升
드陽	三陽
드陰	三陰
드錢	三錢
드焦	三焦
드寸	三寸
드충	두충
드黃	三黃
드黃心湯	三黃瀉心湯
드喜	三喜
득歸膠	芎歸膠
들 수록	들수록
들 어	들어
들 에게	들에게
들 이	들이
들수	들 수
들어 가	들어가
燈	證
腾	臍
등근	둥근
등글	둥글
藤藤子	蘿菔子
騰臂	臑臂
腾上俘	臍上悸
腾上择	臍上悸
등증상	등 증상
腾下	臍下
腾下1季	臍下悸
騰會	臑會
디•	다
디는 	다는 
디루	다루
디른	다른
따 뜻	따 뜻
따 뜻	따뜻
따 라	따라
따라 서 	따라서 
따라일	따라 일
딱 딱	딱딱
때 문	때문
때쓰	때 쓰
때쓴	때 쓴
때좋	때 좋
떨 	떨
떨 어	떨어
떻心湯	瀉心湯
떻吐	嘔吐
또는다	또는 다
또立	王立
또冰	王冰
또昂	王昂
또執中	王執中
또淸	王淸
또學	王學
또한 가지	또 한 가지
또한이	또한 이
또惠	王惠
뚜 렷	뚜렷
뚜껌	뚜껑
뛰 어	뛰어
뛰어	뛰 어
뜻 하	뜻하
뜻 한	뜻한
띠과서	따라서
띠끈	따끈
띠뜻	따뜻
띠리	따라
띠와 서	따라서
띠와서	따라서
懒	懶
라 \^다\.	라 한다.
라 고	라고
라 고 	라고 
라 고 한	라고 한
라 고도	라고도
라 고한	라고 한
라 지	라지
라고하	라고 하
라고한	라고 한
라고한다	라고 한다
라고할	라고 할
라고할 	라고 할 
螺動	蠕動
羅藤	蘿菔
羅富	蘿葍
라사용	라 사용
라정리	라 정리
라틴	 라틴
라하고	라 하고
라하여	라 하여
라하였	라 하였
라한다	라 한다
라할 	라 할 
란 다	란다
欄圓	橢圓
剌	刺
嵐器	崑崙
嵐옮	崑崙
嵐斋	崑崙
拉治	竝治
郎	郞
래 서	래서
래서이	래서 이
莱英	茱萸
랫 	랫
冷铜	冷痢
冷痒	冷痺
掠褐色	棕褐色
掠欄	棕櫚
掠色	棕色
略血	咯血
略血	喀血
량 하	량하
凉隔	凉膈
량함	량 함
러 나	러나
러 나 	러나 
러 므	러므
러 스	러스
러 운	러운
러 졌	러졌
러 지	러지
러 한	러한
러H로	러므로
러가	러 가
러나이 	러나 이 
런 데	런데
런 데이 	런데 이 
런데이 	런 데이 
럽 	럽
렇 	렇
레 르	레르
레 스	레스
레이 저	레이저
렙 토	렙토
驢	鹽
려 고	려고
려 면	려면
려 우	려우
려 운	려운
려 움	려움
려 져	려져
려고한	려고 한
厲党	厲兌
黎盧	藜蘆
驢類	鹽類
驢水	鹽水
厲兒	厲兌
厲요	厲兌
려한다	려 한다
藶大裏	藶大棗
力嘛	加味
練經活	疏經活
蓮翹	連翹
連戴	連翹
連勉	連翹
連麵	連翹
練蜜	煉蜜 
練蜜	煉蜜
蓮白	薤白
連繁	連繫
攣石	礬石
連紹	連軺
蓮翅	連翹
連翅	連翹
連熱湯	蓮翹湯
連魏	連翹
攣睛	攀睛
蓮鍾	蓮翹
連鍾	連翹
連鍾湯	蓮翹湯
戀症	鬱症
戀滯	鬱滯
攣血	鬱血
敛	斂
廉疼	痲疹
齢	齡
令A	令人
苓甘藍味	苓甘薑味
靈框	靈樞
靈框	靈樞
靈框 	靈框樞
靈框樞	靈樞
靈溝	蠡溝
灵氣	炅氣
靈福	靈樞
靈本	藁本
靈植	靈樞
玲羊	羚羊
靈枢	靈樞
苓港	苓湯
苓황	苓湯
例水	冽水
로 는 	로는 
로 부터	로부터
로 서	로서
로 서 	로서 
로 소 	로소 
로 써	로써
로 써 	로써 
로 운	로운
로 움	로움
로 이드	로이드
로 인 하	로 인하
老A	老人
로가	로 가
로개선	로 개선
로교차	로 교차
로구분	로 구분
로구성	로구성
로구성	로 구성
로굽	로 굽
盧根	蘆根
로끓	로 끓
로나	로 나
로내	로 내
로누	로 누
로달	로 달
로돌	로 돌
로되어	로 되어
로된	로 된
盧頭	蘆頭
로들	로 들
로만들	로 만들
로많	로 많
로먹	로 먹
로반죽	로 반죽
로배열	로 배열
로보	로 보
로복용	로 복용
로분류	로 분류
로숙	로 숙
로써서	로 써서
로알려	로 알려
로올	로 올
로옮	로 옮
로운용	로 운용
로움직	로 움직
로응용	로 응용
로이 	로 이 
로인	로 인
로인한	로 인한
로잡	로 잡
로主治	로 主治
로줄	로 줄
勞擦	勞瘵
勞擦	勞瘵
盧蒼	蘆薈
로치료	로 치료
로토	로 토
로퍼	로 퍼
로펴	로 펴
로폭넓	로 폭넓
로표	로 표
로하	로 하
로하여	로 하여
로하여 	로 하여 
로하였	로 하였
로한다	로 한다
로할 	로 할 
로해	로 해
로했	로 했
綠 色	綠色
碌經	疏經
鹿攀	痙攣
록주의	록 주의
鹿奪	鹿茸
祿風	祛風
록한다	록 한다
論」	論』
롱팔	콩팥
롱팥	콩팥
료 법	료법
療 法	療法
疗毒	疔毒
療痺	瘙痒
療瘦	瘰癧
療癌	瘰癧
療癒	瘰癧
疗腫	疔腫
疗瘡	疔瘡
療痛	瘰癧
龙	朮
룡 탕	룡탕
루期	早期
漏盧	漏蘆
蔞蔬白	蔞薤白
樓蘇散	檳蘇散
漏承氣湯	桃核承氣湯
樓息	棲息
樓掷	檳榔
樓鄉	檳榔
룰 	를 
瘤	癎
劉 河	劉河
瘤狂	癲狂
流膽	流膿
留滅	留鍼
留誠	留鍼
類車	頰車
六 味丸	六味丸
六臉	六腑
六膽	六腑
六膽	六腑
六蠻	六鬱
六贿	六腑
륭근	흉근
르 	르
르 고	르고
르 기	르기
르 네	르네
르 러	르러
르 면 	르면 
르 지	르지
勒帶	靭帶
를 띠와	를 따라
를 사\^하	를 사용하
를「	를 「
를가	를 가
를거	를 거
를굴	를 굴
를굽	를 굽
를끓	를 끓
를내	를 내
를낸	를 낸
를넘	를 넘
를넣	를 넣
를느	를 느
를늘	를 늘
를도	를 도
를돕	를 돕
를들	를 들
를따	를 따
를만	를 만
를말	를 말
를멈	를 멈
를바	를 바
를받	를 받
를버	를 버
를보	를 보
를볼	를 볼
를붓	를 붓
를빼	를 빼
를사	를 사
를시	를 시
를요	를 요
를움	를 움
를유지	를 유지
를의	를 의
를이	를 이
를잡	를 잡
를제	를 제
를제거	를 제거
를조절	를 조절
를주	를 주
를중심	를 중심
를증	를 증
를지나	를 지나
를찾	를 찾
를치	를 치
를치료	를 치료
를통	를 통
를튼	를 튼
를포	를 포
를하	를 하
를한	를 한
를할	를 할
를함	를 함
를해	를 해
陵 泉	陵泉
菱했仁	薏苡仁
릍	를
리 고 	리고 
리 기	리기
리 적	리적
리 키	리키
利A	利人
莉芥	荊芥
利窮	利竅
리는 뜻	라는 뜻
莉茶	荊芥
리돔	리듬
리듬	 리듬
利發	利竅
莉防	荊防
莉芬	荊芥
리비도	 리비도
李挺	李梴
麟	鱗
린것	린 것
鱗塞	鱗莖
麟蘇	麟癬
림 프	림프
淋獨	淋濁
淋歷	淋瀝
臨立	臨泣
淋滴	淋漓
립 선	립선
립 신	립신
粒發	竝發
릿 	릿
ᄆ	口
ᄆ 眼	口眼
ᄆ渴	口渴
ᄆ乾	口乾
ᄆ苦	口苦
ᄆ區	嘔
ᄆ襟	口噤
ᄆ舌	口舌
ᄆ眼	口眼
ᄆ燥	口燥
ᄆ瘡	口瘡
ᄆ臭	口臭
嗎	嘔
麼	糜
마 늘	마늘
마 디	마디
마 르	마르
마 른	마른
마 음	마음
마 이너	마이너
마 지	마지
麻各蒼甘	麻杏薏甘
麻庫	麻痺
麻구	麻子
麻疼	麻疹
麻疼	痲疹
麼爛	糜爛
麻务	麻杏
麻捧	痲痺
磨損	虧損
麻瘦	痲痺
麻痒	麻痺
麻疫	麻疹
麻疹	痲疹
麻擦	痲痺
磨窓	膺窓
馬齒竟	馬齒莧
磨香	麝香
麻血	瘀血
漠肝	瀉肝
膜理	腠理
膜滿	脹滿
膜悶	脹悶
막이주	막아주
膜汁	膿汁
寞黑	糞黑
蠻	鬱
弯	穹
만 날	만날
만 족	만족
만 큼	만큼
만\. 	만, 
蠻結	鬱結
漫驚	慢驚
蠻曲	彎曲
弯管	萼管
蠻氣	鬱氣
蠻金	鬱金
蠻怒	鬱怒
蔓莉	蔓荊
蔓莉子	蔓荊子
晚白	晄白
蠻病	鬱病
만아니	만 아니
挽仰	俛仰
蠻熱	鬱熱
蠻欲	鬱欲
蠻者	鬱者
蔓製	薑製
蔓汁	薑汁
蠻症	鬱症
蠻證	鬱證
蠻滯	鬱滯
弯片	萼片
蠻肺	鬱肺
蠻閉	鬱閉
만한다	만 한다
蠻火	鬱火
蔓黃	薑黃
많	 많
많 	많
많이한	많이 한
말 \^다\.	말한다.
말 하	말하
末稍	末梢
芒滅	芒鍼
芒碑	芒硝
芒銷	芒硝
망싱	망상
芒稍	芒硝
芒稱	芒硝
芒砲	芒硝
芒确	芒硝
芒確	芒硝
맞 	맞
毎	每
매 우	매우
매 일	매일
매 핵	매핵
埋滅	埋鍼
罵冒	罵詈
매일아침	매일 아침
梅指	拇指
脉	脈
麥大藥湯	麥大棗湯
脈浪	脈澁
脈流	脈澁
脈液	脈澁
脈孺	脈濡
脈이 流	脈이 澁
脈짧	脈澁
萌果	蒴果
머 리	머리
머리위	머리 위
멈 	멈
메털	메틸
며이	며 이
糸工	紅
면 서 	면서 
면 역	면역
면 이 	면이 
면\. 	면, 
面揭	面褐
면더욱	면 더욱
면된다	면 된다
面微有壅	面微有塵
面壅	面塵
면이 	면 이 
면좋	면 좋
면한다\.	면 한다.
면효	면 효
滅 灸	鍼灸
滅感	鍼感
滅經	鍼經
滅과	鍼과
滅灸	鍼灸
蔑麻	蓖麻
蔑白	蔥白
滅法	鍼法
滅柄	鍼柄
滅으	鍼으
滅을	鍼을
滅이	鍼이
滅入	鍼入
滅刺	鍼刺
滅尖	鍼尖
滅治	鍼治
明 目	明目
명확 하	명확하
몇번	몇 번
모 델	모델
모 든	모든
모 르	모르
모 양	모양
牡！嘱	牡蠣
牡«湯	牡蠣湯
牡■湯	牡蠣湯
牡機	牡蠣
牡螺	牡蠣
毛良科	毛茛
모려 탕	모려탕
牡蠣끓	牡蠣湯
牡蠣淸	牡蠣湯
牡蠣황	牡蠣湯
모르 핀	모르핀
모르펀	모르핀
暮痲	蕁痲
牡瑪	牡蠣
毛莫科	毛茛科
牡耀	牡蠣
牡場	牡蠣
牡蝶	牡蠣
牡嘱	牡蠣
牡爆	牡蠣
牡嫌 湯	牡蠣湯
模形	楔形
목 단	목단
牧 丹	牧丹
目 目玄	目眩
目 醫	目翳
目 赤	目赤
目艮	眼
목단피 탕	목단피탕
木戀	木鬱
目流眼花	目澁眼花
目目玄	目眩
目聞	瞤
目銳皆	目銳眥
目醫	目翳
睦子	瞳子
睦臓	膵臟
目肢	目眩
目港眼	目澁眼
目弦	目眩
目玄	眩
몰이•	몰아
몸 통	몸통
몸푼	몸 푼
못 \^다\.	못 한다.
못朴湯	柴朴湯
못實	芡實
못馳龍骨	柴胡加龍骨
못胡	柴胡
夢蘇飮	蔘蘇飮
庙	疝
庙硬	痞硬
描溺	搐搦
墓味	薑味
墓本	藁本
描熱	疳熱
墓汁	薑汁
무 릎	무릎
무 리	무리
무 엇	무엇
無膽	無膿
無力或乳	無力或芤
무룻	무릇
무를을	무릎을
무릎을 끓	무릎을 꿇
無菩	無苔
무엇 보다	무엇보다
무의 식	무의식
무자이중	부자이중
無疲	無痰
黙	默
门	門
문 제	문제
文!哈	文蛤
文給	文蛤
문류	분류
門賛言	門贅言
물 론	물론
물 질	물질
勿課藥	勿誤藥
물링	물렁
므 	므
므 로	므로
므 로 	므로 
므\^ 	므로 
米\?甘	米泔
糜爛	穈爛
眉稜	眉陵
眉梭	眉稜
眉梭骨	眉稜骨
梶圓	橢圓
梶子	梔子
彌中景	張仲景
尾紙	尾骶
미지 황	미지황
眉稷	眉陵
眉稷	眉稜
味툴 	味를 
민김	민감
민들어	만들어
믿 	믿
밀 접	밀접
蜜塞	壅塞
蜜盛	壅盛
蜜炎	蜜炙
蜜陰	竅陰
蜜滯	壅滯
蜜閉	壅閉
밀해	말해
蜜血	鬱血
및	 및 
및  	및 
밑등	밑둥
바 깥	바깥
바 닥	바닥
바 란	바란
바 른	바른
바로그	바로 그
바로위	바로 위
剥	剝
밖 의	밖의 
攀	攣
攀 	攣
반 대	반대
반 드	반드
반 리비도	반리비도
반 복	반복
반 응	반응
半 夏	半夏
攀結	鬱結
攀急	攣急
斑疼	斑疹
攀發	鬱發
搬粉	澱粉
潘盛	燔盛
潘養	濡養
攀摇	攣搐
반웅	반응
攀閉	鬱閉
받 	받
받of	받아
받이#여	받아들여
받이#이	받아들이
받이\"	받아
받이•	받아
발 가락	발가락
발 견	발견
발 달	발달
拔 滅	拔鍼
발 목	발목
발 병	발병
발 생	발생
발 작	발작
발 전	발전
發疼	發疹
發로	竅로
발로서 있	발로 서 있
拔滅	拔鍼
發渗	發疹
발생 하	발생하
拔誠	拔鍼
拔爷	茯苓
發彦	發疹
發彥	發疹
撥竹	攢竹
밝 	밝
밝하	밝히
庞	疣
膀 胱	膀胱
방 법	방법
방 사	방사
방 식	방식
방 지	방지
방 향	방향
肪間	肋間
防驚	防禦
膀胱命	膀胱兪
防禁	防禦
防己易	防己湯
방둥통	방풍통
방뚱통	방풍통
방뚱통성	방풍통성
膀傍	臍傍
방법을 사\^하	방법을 사용하
膀邊	臍邊
膀部	臍部
방사 통	방사통
膀上悸	臍上悸
膀腕	膀胱
膀犹	膀胱
妨維	紡錐
防已	防己
妨鍾形	紡錐形
膀左	臍左
방줌통성	방풍통성
膀脫	膀胱
膀脱	膀胱
膀耽	膀胱
방품통	방풍통
방풍통 성 산	방풍통성산
膀下	臍下
膀下悸	臍下悸
膀下怪	膀下悸
膀恍	膀胱
배 꼽	배꼽
配 伍	配伍
배 출	배출
배 합	배합
配 合	配合
配 穴	配穴
培乾	焙乾
排膽	排膿
排騰	排膿
排膜	排膿
背命	背兪
背毛	茸毛
排腹筋	腓腹筋
排腸筋	腓腸筋
白 ： E	白芷
白 求	白朮
白 色	白色
白 芍	白芍
白 朮	白朮
백 태	백태
白 蔽	白蘞
白:！ti	白朮
白:£	白芷
白:E	白芷
白；E	白芷
白S	白芨
白Tit	白朮
白Ttfc	白朮
白苦	白苔
白求	白朮
白答	白苔
白戴	白酨
白獨	白濁
白攀	白礬
白菩	白苔
白賦	白膩
白宣寇	白荳蔲
白与	白芍
白醫	白翳
白才L	白朮
白척	白芍
白遷霞	白彊蠶
白朮 天麻湯	白朮天麻湯
白蔽	白蘞
白포	白芷
白표	白芨
柏皮	栢皮
白효	白芷
백희	백회
버 리	버리
繁 甲	鱉甲
번 째	번째
繁甲	鱉甲
煩宽	煩寃
幡蔑	蟠蔥
煩憑	煩懣
繁舌本	繫舌本
番誠	番鍼
繁於	繫於
煩潤	煩瞤
繁張	緊張
煩淨	煩悸
幡葱	蟠葱
煩择	煩悸
蕃했仁	薏苡仁
繁血	鱉血
범 위	범위
법게	볍게
벗 	벗
僻囊	澼囊
僻地	擗地
변 비	변비
邊 緣	邊緣
변 화	변화
辨if	辨證
辨it	辨證
辨m	辨證
變積	鬱積
변중	변증
변증\(辨譜	변증(辨證)
변증과치료	변증과 치료
變滯	鬱滯
變血	瘀血
변회	변화
별 히	별히
별에 말	볕에 말
併	倂
餅	餠
병 리	병리
병 변	병변
병 원	병원
병 적인	병적인
병 형 분류	병형 분류
病A	病人
병형분류	병형 분류
辅	輔
보 감	보감
보 다 	보다 
보 면 	보면 
補 法	補法
보 여	보여
보 통	보통
보 혈	보혈
보깅	보강
보디는	보다는
補滅	補鍼
菩白	苔白
補誠	補鍼
譜語	譫語
補醫	補腎
菩焦	苔焦
補賢	補腎
福	樞
복 근	복근
복 력	복력
복 령	복령
복 부	복부
腹 部	腹部
복 사	복사
복 용	복용
服 用	服用
복 통	복통
伏鬼	伏兎
複棄	複葉
茯茶	茯苓
腹服	腹脹
腹腹	腹脹
복불 인	복불인
腹腺	腹脹
服用 한 	服用한 
복은 것	볶은 것
복잡 하	복잡하
腹張	腹脹
腹清	腹瀉
茯측	茯苓
茯층	茯苓
伏兔	伏兎
茯품	茯苓
腹皮鄉	腹皮拘攣
茯혼	茯苓
볶 	볶
본 능	본능
본 래	본래
本 品	本品
본것	본 것
볼수	볼 수
볼수있	볼 수 있
捧	痺
棒	悸
蜂	蜂
棒瘡	痔瘡
俘	悸
不 	不
부 근	부근
부 드	부드
부 분	부분
不 隨	不隨
부 위	부위
部 位	部位
附 子	附子
부 족	부족
부 종	부종
不 進	不進
부 착	부착
부 터	부터
부 하	부하
부\(膽\)	부(腑)
婦A	婦人
附A	附人
賦苦	膩苔
附구	附子
肤痰	祛痰
부맥\(浮月© 	부맥(浮脈)
部門	郄門
副臂	副腎
不濱	不瀉
부沙	부(少
부식■	부삭
腐心	瀉心
府熱	疳熱
肤癒	祛瘀
敷陰	竅陰
不妊	不姙
不敵	不斂
浮郑	浮郄
附腫	胕腫
腐触	腐蝕
肤風	祛風
肤寒	祛寒
肤痕	祛痰
体	體
분 노	분노
分 量	分量
분 류	분류
분 비	분비
분 야	분야
분 포	분포
奔M	奔豚
盆氣	益氣
愤濃	懊憹
分挽	分娩
分晚	分娩
奔脈	奔豚
奔脉	奔豚
噴噴	噴嚔
奔膝	奔豚
愤憶	懊憹
奮香	藿香
불 가능	불가능
불 리	불리
불구 하	불구하
불렀	 불렀
佛蠻	怫鬱
불웅	불응
붓 고	붓고
鹏	臍
棚砂	硼砂
붕투	붕루
鹏下	臍下
鹏虫	蛔蟲
붙 	붙
비 골	비골
비 교적	비교적
비 뇨	비뇨
비 록	비록
비 롯	비롯
비 만	비만
備 用	備用
秘 典	秘典
비\(牌\)	비(脾)
臂經	臂脛
臂曲	彎曲
脾骨	髀骨
脾關	髀關
비교 적	비교적
臂氣	腎氣
鼻紐	鼻衄
臂騰	臂臑
臂時	臂肘
鼻室	鼻窒
비癌	비痞
臂陽	腎陽
臂外眥	臂外皆
備圓	橢圓
臂俞	腎俞
脾臓炎	膵臓炎
脾樞	髀樞
脾枢	髀樞
비타민\(:	비타민C
비타민2	비타민E
비타민8	비타민B
臂虛	腎虛
脾賢	脾腎
臂形	脣形
濱	瀉
頻 尿	頻尿
빈 번	빈번
濱肝	瀉肝
滨肝	瀉肝
宾門	箕門
濱法	瀉法
濱心	瀉心
滨心	瀉心
濱蕩	潰瘍
濱血	瀉血
濱火	瀉火
빋이들•	받아들
빙•어	방어
빙어	방어
ᄈ	痿症
빨 리	빨리
빴 	빴
빼脇	胸脇
뻣 뻣	뻣뻣
뾰 	뾰
뾰鈴	兜鈴
뿌 리	뿌리
ᄉ	人
ᄉ®	人蔘
ᄉ赛	人蔘
ᄉ蔡	人蔘
ㅅ	人
邪 客	邪客
사 고	사고
史 記	史記
사 람	사람
瀉 法	瀉法
사 실	사실
사 회	사회
사\(德\)	사(瀉)
사\(濱\)	사(瀉)
四\*	四大
사\^I龍湯	小靑龍湯
사§•	사용
사0寫	사(瀉
射關節	肘關節
사구채	사구체
祀菊	杞菊
사균자	사군자
瀉铜	瀉痢
瀉爛	潰爛
사로 잡	사로잡
사림	사람
捨滅	捻鍼
四物蘭	四物湯
四物港	四物湯
四物황	四物湯
사상의 학	사상의학
梭線	稜線
사심 탕	사심탕
舍厳	舍巖
四逆끓	四逆湯
四逆淸	四逆湯
四逆港	四逆湯
思邀	思邈
사용 하	사용하
사용 한	사용한
사운할	사용할
捨轉	捻轉
捨挫	捻挫
사진\(四談	사진(四診
沙參	沙蔘
赦瘡	斂瘡
舍躲	舍巖
朔果	蒴果
삭맥\(數M	삭맥(數脈
產	産
산 소	산소
산\-엔돌핀	β-엔돌핀
酸S仁	酸棗仁
酸轰	酸棗
酸轰仁	酸棗仁
酸棄仁	酸棗仁
酸裏	酸棗
山梅子	山梔子
酸腹	酸脹
酸腹感	酸脹感
散슴	散合
酸藥仁	酸棗仁
散癒	散瘀
산조 인	산조인
酸秦	酸棗
酸秦仁	酸棗仁
山菜英	山茱萸
散蔽	散瘀
散疲	散瘀
酸酵	醱酵
薩	癃
撒梗	繖梗
살된 	살 된 
撒房	繖房
薩白	薤白
撒狀	繖狀
살수	살 수
살펴 보	살펴보
살피보	살펴보
撒形	繖形
撒花	繖花
渗	滲
삼 각	삼각
三 卷	三卷
三 里	三里
삼 소음	삼소음
三 陰	三陰
三 焦	三焦
三理	三里
三痿症	三稜鍼
三際各	三陽絡
插子	梔子
상 당히	상당히
桑 白	桑白
상 징	상징
상 태	상태
상 한론	상한론
상 황	상황
傷A	傷人
上ft症	上氣症
상각근	삼각근
상과임상	상과 임상
相勉	相剋
上敷	上竅
傷臂	傷腎
相葉	栢葉
上脘叢	上腕叢
上院	上脘
箱子	葙子
上充	上亢
上七發	上七竅
상태를	상태를 
상하\^뇌하	상하부-뇌하
상한론 總論	상한론傷寒論
상한론«論	상한론傷寒論
상한론mr論	상한론傷寒論
상한론췌論	상한론傷寒論
상한론했論	상한론傷寒論
上骸	上髎
傷賢	傷腎
赛	萎
새 로	새로
塞味	薑味
赛香	麝香
赛黃	萎黃
색\(畜\)	색(嗇)
索亂	紊亂
생 각	생각
생 강	생강
생 강탕	생강탕
생 겨	생겨
생 기	생기
生 氣	生氣
생 긴	생긴
생 님	생님
생 명	생명
생 물	생물
생 산	생산
생 체	생체
생 활	생활
生■湯	生薑湯
생각 하	생각하
생강 탕	생강탕
생강3	생강 3
生薑황	生薑湯
生舊	生薑
생긱	생각
生臺	生薑
生蓮	生薑
生蓮湯	生薑湯
生理 痛	生理痛
생리 학	생리학
生蔓	生薑
생명활\^	생명활동
生墓	生薑
生醫	生翳
生晝	生薑
生蓄	生薑
生疲	生痰
生畫	生薑
緒	緖
서 늘	서늘
서 양의학	서양의학
서I 	세 
鼠瘦	鼠瘻
서양의 학	서양의학
서이 	서 이 
石 膏	石膏
石科	石斛
石料	石斛
石賣	石膏
夕卜	外
石裔	石膏
石青	石膏
石乏	砭
腊下	臍下
섞 	섞
善 忘	善忘
선 상	선상
선 생	선생
선 택	선택
선\-엔돌핀	β-엔돌핀
宣蠻	宣鬱
腺滿	脹滿
선밍	선망
禪蛻	蟬蛻
禪悅	禪蛻
宣옮	崑崙
禪脫	蟬蛻
禪退	蟬退
설 명	설명
설 사	설사
泄 薦	泄瀉
설 탕	설탕
說皆	銳眥
泄遣	泄瀉
舌苦	舌苔
泄滚	泄瀉
說骨	銳骨
泄德	泄瀉
泄涛	泄瀉
舌綠	舌絳
설명 하	설명하
舌菩	舌苔
泄潟	泄瀉
薛膝炎	膵臓炎
泄濕	泄瀉
泄憶	泄瀉
泄演	泄瀉
泄遠	泄瀉
薛臓	膵臟
泄滴	泄瀉
설정 하	설정하
泄薦	泄瀉
泄清	泄瀉
泄湯	泄瀉
舌笞	舌苔
泄篇	泄瀉
泄鶴	泄瀉
泄海	泄瀉
泄嬉	泄瀉
繊	纖
섬 유	섬유
摄	證
섭 취	섭취
성 분	성분
聖A	聖人
聲卿	聲嘶
聲嘔	聲喝
誠灸	鍼灸
聲聊	聲嘶
誠法	鍼法
聲晰	聲嘶
誠術	鍼術
誠은	鍼은
誠刺	鍼刺
성종 양	성종양
誠治	鍼治
醒通學	匯通學
细	細
세 균	세균
세 신탕	세신탕
세 포	세포
세된	세 된
세번	세 번
세올®	세올^®^
셉기	씹기
션파	β파
소 건중	소건중
소 금	소금
素 問	素問
소 변	소변
小 柴胡	小柴胡
少 陽	少陽
少 陰	少陰
소 청룡	소청룡
소 통	소통
小 便	小便
消 化	消化
小A	小人
小技	小枝
蘇棄	蘇葉
小督	小眥
소뚱산	소풍산
蔬白	薤白
少菩	少苔
소복\(小膨	소복(小腹)
銷狀	鞘狀
燒誠	燒鍼
小勝經	小腸經
소실 되	소실되
消深	消爍
消癌	消痞
소양 병	소양병
消癒	消癰
小稳	小穗
소줌산	소풍산
소청룡	소청통
小靑龍 湯	小靑龍湯
소청통	소청룡
燒蟲	蟯蟲
銷齒	鋸齒
消褒	消痰
소품산	소풍산
素骸	素髎
蘇血	瘀血
少衡	少衝
소회될•량	소화불량
속 적	속적
손 가락	손가락
손 바닥	손바닥
손 상	손상
손가 탁	손가락
손과발	손과 발
손롭	손톱
孫思it	孫思邈
孫思M	孫思邈
損竹	攢竹
摔痛	痺痛
晒 乾	晒乾
衰 弱	衰弱
쇼痛	止痛
수 \^다	수 있다
水 量	水量
수 면	수면
睡 眠	睡眠
수 있다	 수 있다
수\^체	수용체
수§•체	수용체
水甘 湯	朮甘湯
瘦库	瘙痒
收敎	收斂
水灸	水炙
瘦厥	痙厥
瘦厥	痿厥
수기\(水놓	수기(水氣
瘦療	瘦瘠
收流	收澁
瘦瘤	癭瘤
壽痲疹	蕁麻疹
手滅	手鍼
水滅	水鍼
瘦攀	痙攣
瘦捧	瘙痒
收赦	收斂
瘦瘦	瘦瘠
수없	수 없
瘦軟	痿軟
收溫	收澁
瘦飮	痰飮
수있	수 있
水張	水脹
收敵	收斂
手足滅	手足鍼
瘦腫	癰腫
寿瘡	痔瘡
瘦痛	痠痛
水抱	水疱
水泡	水疱
瘦疲	瘈瘲
水鶴	水鷄
愁火	慾火
숙 변	숙변
淑水	漱水
宿초	宿主
순 환	순환
純頭	鈍頭
循騰	循臑
純圓	鈍圓
循子	梔子
純痛	鈍痛
荀片	苞片
숫 	숫
嵩	窩
숭모근	승모근
숲\{募	金傷
쉽 	쉽
스 러	스러
스 런	스런
스 리	스리
스 테로	스테로
스 트	스트
스 트레	스트레
스스 로	스스로
스테톨	스테롤
스트 레	스트레
슬 관절	슬관절
슬 러	슬러
膝臓炎	膵臓炎
膝苔	膩苔
슬품	슬픔
膝疲軟	膝痠軟
습 관	습관
濕 潤	濕潤
濕溝	濕濁
濕獨	濕濁
濕疼	濕疹
濕戀	濕鬱
濕蠻	濕鬱
濕渗	濕疹
濕摔	濕痺
濕心	瀉心
濕痒	濕痺
濕彥	濕疹
濕疫	濕疹
濕營	濕鬱
拾挫	捻挫
濕懲	濕鬱
濕疲	濕痰
濕痕	濕痰
승 마	승마
승:\)1탕	승기탕
승e근	승모근
承ft湯	承氣湯
勝胱	膀胱
승기 탕	승기탕
承氣끓	承氣湯
承氣港	承氣湯
承氣海	承氣湯
勝臓	膵臓
승회\"Sub	승화sub
时	時
시 간 	시간 
시 냅	시냅
시 대	시대
始 生	始生
時 尖	肘尖
시 켜	시켜
시 키	시키
시 키는	시키는
시 킨	시킨
시 킬	시킬
시 킴	시킴
柴 胡	柴胡
시"	사
시■용	사용
시·용	사용
시•	사
시•용	사용
시계 지건강팅	시호계지건강탕
時關	肘關
시군자	사군자
시넷	시냇
柴茶	柴苓
始糖	飴糖
柴勵ms	柴胡加
時髎	肘髎
施滅	施鍼
柴朴渴	柴朴湯
시박팅	시박탕
廝旁	臍旁
時部	肘部
時臂	肘臂
시상의 학	사상의학
시상의학	사상의학
시상히\^	시상하부
시술지	시술자
시싱•	사상
柴爷	柴苓
時外	肘外
시용	사용
시율계지\^\"	시호계지탕
時中	肘中
時尖	肘尖
柴측	柴苓
柴층	柴苓
時骸	肘髎
柴胡桂枝溪	柴胡桂枝湯
柴胡溝肝	柴胡淸肝
柴胡易	柴胡湯
柴胡游	柴胡湯
柴胡場	柴胡湯
柴혼	柴苓
柴홉	柴苓
时後	肘後
柴휴	柴苓
柴흑湯	柴苓湯
柴흡湯	柴苓湯
식 초	식초
식 품	식품
食®	食鹽
食攀	食鬱
食餅	食餌
殖泄	飱泄
食愁	食慾
식은 땀	식은땀
食懲	食鬱
媳風	熄風
殖霞	殭蠶
慎	瀉
肾	腎
신 경	신경
神 經	神經
신 경통	신경통
신 전	신전
신 진대사	신진대사
신 체	신체
新 編	新編
신 호	신호
신\(臂\)	신(腎)
신\(背\)	신(腎)
신\(賢\)	신(腎)
신경 염	신경염
신경 학	신경학
神關	神闕
腎孟	腎盂
身体	身體
神誠	神鍼
识實	枳實
신양허W陽	신양허腎陽
腎翁	腎兪
신음허W陰	신음허腎陰
辛夷	辛荑
神闘	神闕
身疲療	身痲痺
辛喊	辛鹹
신허Wit 	신허腎虛
신賢	신腎
娠眩	賑眩
慎火	瀉火
慎懷	懊憹
실 시	실시
實 熱	實熱
실 제	실제
실 증	실증
실 행	실행
실 험	실험
室塞	窒塞
室葉	莖葉
실이•	살아 
실資	실實
심 각	심각
심 리	심리
心 法	心法
심 신	심신
心 有	心有
심 장	심장
심 전도	심전도
심 층	심층
心窮	心竅
深綠	深絳
心萬部	心窩部
心發	心竅
心棒	心悸
心俘	心悸
心愁	心慾
心窝해	心窩部
心淨	心悸
心中癌	心中痞
心慘	心悸
心择	心悸
心下居	心下痞
心下怪	心下悸
心下窟鞭	心下痞鞭
心下唐	心下痞
心下病硬	心下痞硬
心下俘	心下悸
심하비 견	심하비견
心下宿	心下痞
心下癌	心下痞
心下癌5M	心下痞硬
心下淨	心下悸
心下痛	心下痞
心賢	心腎
심히\(心	심하(心
十A	十人
十裏湯	十棗湯
十秦	十棗
싱•	상
싱습	상습
싱승	상승
싶 	싶
쌍등이	쌍둥이
쌓 	쌓
썰 	썰
쑤 어	쑤어
쓸수	쓸 수
氏滅	氏鍼
씩끓	씩 끓
씩복용	씩 복용
씻 	씻
ᅀ시J：\^■	소시호탕
ᄋr	or
鸦	鴉
아 니	아니
아 닌	아닌
아 드레	아드레
아 래	아래
아 미노	아미노
아 버	아버
아 야	아야
아 직	아직
아 프	아프
아 픈	아픈
牙艱	牙齦
아을러	아울러
牙鳥	鴉
아품	아픔
아픈 쪽	아픈쪽
악 화	악화
惡賠	惡虧
安 中勸	安中散
眼棄	眼窠
顏動	顫動
안좋	안 좋
按之儒	按之濡
按之篇	按之濡
按之漂	按之濡
안태지투	안태지루
按하면 儒	按하면 濡
按該	按診
眼險	眼瞼
顔會	顖會
앉하	앉히
않 	않
알 레	알레
알 아	알아
알 코	알코
알수	알 수
알이•	알아
胺風	祛風
앓고난	앓고 난
癌	癲
暗 褐	暗褐
癌硬	痞硬
癌滿	痞滿
癌塞	痞塞
癌痒	瘙痒
압 통	압통
壓 痛	壓痛
鴨妬	鴨跖
았 	았
앞위	앞 위
艾械	艾絨
艾住	艾炷
艾柱	艾炷
애칙	애착
額顧	額顱
額厭	頷厭
앤 다	앤다
爷甘	苓甘
爷桂	苓桂
夜茶	茯苓
惹白	蔥白
夜爷	茯苓
惹졌仁	薏苡仁
夜측	茯苓
야한다	야 한다
爷後	茯苓
夜휴	茯苓
약 간	약간
약 물	약물
약 재	약재
약 화	약화
약 효	약효
약간다	약간 다
藥滅	藥鍼
藥餅	藥餌
薬本	藁本
藥賓	蕤賓
약한불	약한 불
陽 A	陽人
陽 經	陽經
陽 明	陽明
陽 維	陽維
陽A	陽人
양계\(隨\)	양계(陽谿)
陽踏	陽蹻
양룽	양릉
양명 병	양명병
陽上充	陽上亢
陽瘦	陽痿
嚷逆	噦逆
壤玉膏	瓊玉膏
養졌仁	薏苡仁
陽充	陽亢
陽豁	陽谿
於 	於
어 깨	어깨
어 나\,	어나,
어 느	어느
어 떠	어떠
어 떤	어떤
어 렵	어렵
어 린	어린
어 서 	어서 
어 야 	어야 
어 야한다	어야 한다
어 울	어울
魚 際	魚際
어 져	어져
어 지게	어지게
어 지는	어지는
어 진다	어진다
어 찌	어찌
어느정	어느 정
어먹는	어 먹는
어복용	어 복용
어야한다	어야 한다
어혈\(疲血	어혈(瘀血
억 간산	억간산
억간 산	억간산
抑蠻	抑鬱
언 제	언제
言歸躍艾湯	芎歸膠艾湯
彦陣	彦暉
얼 굴	얼굴
엄 지	엄지
掩子	梔子
掩指	拇指
없 	없
없디	없다
었 	었
었 다	었다
엉 덩	엉덩
엉덩 이	엉덩이
에 게	에게
에 너	 에너
에 띠과	에 따라
에 띠와	에 따라
에 서	에서
에 서 	에서 
에 서는	에서는
에 서도	에서도
에 의 	에의 
에의 한	에 의한
에의 해	에 의해
에 이 용	에 이용
에 게	에게
에 서 	에서
에가 깝	에 가깝
에게이 	에게 이 
에게재	에 게재
에관	에 관
에까	에 까
에나 누어	에 나누어
에나와	에 나와
에넣	에 넣
에놓	에 놓
에달	에 달
에담	에 담
에대	에 대
에도움	에 도움
에들	에 들
에디슨병	애디슨병
에따	에 따
에많	에 많
에먹	에 먹
에복용	에 복용
에분포	에 분포
에사용	에 사용
에서 는 	에서는 
에서 도 	에서도 
에서서 	에 서서 
에서이 	에서 이 
에서할	에서 할
에실	에 실
에쓰인	에 쓰인
에씻	에 씻
에위치	에 위치
에응용	에 응용
에의	에 의
에의해	에 의해
에이 	에 이 
에있	에 있
에작	에 작
에적	에 적
에좋	에 좋
에한	에 한
에효	에 효
엑 기스	엑기스
엑기 스	엑기스
엔 돌핀	엔돌핀
舆	輿
여 겨	여겨
여 러	여러
여 서 	여서 
여 야 	여야 
여 윈	여윈
여기이 	여기 이 
여넓	여덟
여러가지	여러 가지
여러번	여러 번
輿貌	輿輗
輿稅	輿輗
輿税	輿輗
여야한다	여야 한다
与藥	芍藥
역 시	역시
역 할	역할
疫飲	痰飮
研	硏
铅	鉛
연 결	연결
연 관	연관
연 구	연구
연싱	연상
緣刺	繆刺
演肺	瀉肺
演火	瀉火
열 매	열매
熱督癒	熱瞀瘛
熱铜	熱痢
熱蠻	熱鬱
熱張	熱脹
熱疲	熱痰
염 두	염두
염 제	염제
염 좌	염좌
염 증	염증
炎甘草	炙甘草
厌茶	茯苓
厌측	茯苓
焰稱	焰硝
葉銷	葉鞘
葉蔽	葉腋
였 	였
였 다	였다
赢	羸
颖	穎
영 감강미	영감강미
영 향	영향
榮穴	滎穴
옆드	엎드
옆드려	엎드려
鋭	銳
예 방	예방
예 후	예후
瞖膜	翳膜
藝賓	蕤賓
烏 頭	烏頭
오 래	오래
오 령산	오령산
오 른	오른
五 神	五神
五 臓	五臓
五 흡散	五苓散
오 히	오히
梧梗	桔梗
吳鞕通	吳鞠通
梧구	梧子
澳濃	懊憹
澳惱	懊惱
五茶	五苓
五茶散	五苓散
汚獨	汚濁
吳莱焚	大黃湯
吳莱焚	吳茱萸
吳莱雙	吳茱萸
吳莱英	吳茱萸
吳莱奥	吳茱萸
吳莱黃	吳茱萸
吳莱黄	吳茱萸
澳散	渙散
五腺	五臟
五爷	五苓
五癒津	五癮津
五ᄎ	五大
吳菜！！	吳茱萸
吳菜!!	吳茱萸
吳菜！!	吳茱萸
吳菜契	吳茱萸
吳菜英	吳茱萸
吳菜奥	吳茱萸
吳菜黃	吳茱萸
五측散	五苓散
五行滅	五行鍼
五혼散	五苓散
五홉	五苓
五홉散	五苓散
五華散	五苓散
澳懷	懊憹
五휴	五苓
五휴散	五苓散
五흉散	五苓散
五흡散	五苓散
오ᅡ	와
屋醫	屋翳
温	溫
蕴	蘊
溫 胞	溫煦
溫i»	溫膽
온갖	온갖 
온갖([^ ]?)	온갖 $1
온경 탕	온경탕
溫滅	溫鍼
溫臂	溫腎
溫脾황	溫脾湯
穩狀	穗狀
穩狀花	穗狀花
올 리	올리
올 린	올린
올수	올 수
옮 	옮
옹\(癒\)	옹(癰)
雍白	薤白
翁府	兪府
擁瘦	癱瘓
擁圓	橢圓
擁腫	癰腫
癰着	癒着
窝	窩
窝肝	瀉肝
와같	와 같
와관련	와 관련
와르룽	와르릉
와목	와 목
窝心	瀉心
와있	와 있
와팔	와 팔
와함께	와 함께
腕腹	脘腹
完花	芫花
完活	羌活
왔 	왔
旺門	肛門
外 關	外關
외 측	외측
外 賢	外腎
外皆	外眥
外課	外踝
外跟	外踝
外裸	外踝
外普	外眥
외싱	외상
外躁	外踝
외즉	외측
外賢	外腎
왼성	완성
요 법	요법
腰 痛	腰痛
腰«	腰痛
要缺	要訣
摇溺	搐搦
揺溺	搐搦
腰紙	腰骶
耀閉	癃閉
腰훑	腰痛
욕 구	욕구
欲\*	欲大
欲嫩	欲漱
欲嚇	欲嚥
용 골모려	용골모려
용 된	용된
用 하	用하
用 穴	用穴
蓉石	礬石
冗盛	亢盛
冗進	亢進
祐	祛
于 	于
우 리	우리
우 울	우울
우 유	우유
우I	위
牛姜子	牛蒡子
牛萝子	牛蒡子
우려 먹	우려먹
牛勞子	牛蒡子
우리 나라	우리나라
牛夢子	牛蒡子
憂攀	憂鬱
右膀	右臍
祐邪	祛邪
祐濕	祛濕
우을	우울
우을증	우울증
尤進	亢進
牛秦子	牛蒡子
牛蒂子	牛蒡子
祐風	祛風
祐疲	祛瘀
牛皮癒	牛皮癬
祐寒	祛寒
祐換血	袪瘀血
祐痕	祛痰
우ᅵ	위
욱좋	욱 좋
운 동	운동
운 용	운용
運滅	運鍼
운물	운 물
운증	운 증
울 체	울체
움 직	움직
웅 용	응용
雄藤	雄蕊
雄蓝	雄蕊
雄蔬	雄蕊
雄蘇	雄蕊
웅용	응용
雄滋	雄蕊
원 인	원인
圓 柱	圓柱
原 穴	原穴
圓 形	圓形
援茶	茯苓
院腹	脘腹
院腹	脘脹
圓維	圓錐
圓雜	圓錐
월 경	월경
月干	肝
月艮 用	服用
月工	肛
月力	肋
越姆	越婢
月卑	脾
越碑	越婢
月市	肺
月旨	脂
偽	爲
偽	僞
喂	嘔
爲 	爲
衛 氣	衛氣
위 암	위암
위 염	위염
위 치	위치
위 한	위한
위 해	위해
위\(爲\) 	위(僞) 
胃家费	胃家實
胃茶湯	胃苓湯
緯色	絳色
胃胺	胃脘
胃爷	胃苓
胃腕	胃脘
胃院	胃脘
謂之 	謂之
위해 서	위해서
윗 부분	윗부분
儒	濡
孺	濡
俞	兪
喻	喩
有 	有
儒 門	儒門
유 발	유발
유 사	유사
有 餘	有餘
유 형	유형
癒癎	癲癎
癒狂	癲狂
游囊	澼囊
有膽	有膿
癒膽	癰膿
癒疼	癮疹
유뜰	유돌
癒膜	癰膿
유메iirni	유머hum
유메lu	유머hu
癒門	瘂門
癒斑	瘀斑
癒病有五	癲病有五
癒病之	癲病之
愈府	兪府
癒屬喜	癲屬喜
乳瘦	乳癰
儒養	濡養
遊遙	逍遙
遺遙	逍遙
瑜垣	踰垣
癒爲心血	 癲爲心血
乳癒	乳癰
癒谊	癰疽
癒滴	癲癎
癒点	瘀点
癒點	瘀點
癒腫	癰腫
游主之	湯主之
癒瘡	癰瘡
癒滯	瘀滯
維體	錐體
癒則癎	癲則癎
癒則宜	癲則宜
癒閉	癃閉
有疲	有痰
柔疲	柔痙
游合	湯合
癒血	瘀血
癒桓	癰疽
儒滑	濡滑
癒痕	癰疽
육 체	육체
육경\(六@	육경(六經)
육균자	육군자
肉目間	肉瞤
育俞	肓兪
肉潤	肉瞤
肉觸	肉瞚
潤 膚	潤膚
潤動	瞤動
으 	으
으 나	으나
으 나 	으나 
으 로	으로
으 며	으며
으 면	으면
으 면 	으면 
으 키	으키
으 킨	으킨
으\|	의
으I	의
으I 	의 
으로 하	으로하
으로하	으로 하
으ᅵ	의
으ㅣ	의
稳	穗
은 묶	은 묽
은것	은 것
은게 	은 게 
은곳	은 곳
銀交	齦交
은느낌	은 느낌
은다음	은 다음
은물	은 물
稳狀	穗狀
은아니	은 아니
은의 사의	은 의사의
은이 	은 이 
銀鍾散	銀翹散
은중간	은 중간
은쪽	은 쪽
은처방	은 처방
을 띠와	을 따라
을 수록 	을수록
을 人傳	을 사용
을가	을 가
을가 	을 가
을가 지	을 가지
을가지	을 가지
을갖	을 갖
을개선	을 개선
을건조	을 건조
을것	을 것
을결	을 결
을경우	을 경우
을고정	을 고정
을공격	을 공격
을구별	을 구별
을굽	을 굽
을忌	을 忌
을깨	을 깨
을끓	을 끓
을나타	을 나타
을낫	을 낫
을내	을 내
을내고	을 내고
을넣	을 넣
을높	을 높
을놓	을 놓
을느	을 느
을늘	을 늘
을돌	을 돌
을돕	을 돕
을동반	을 동반
을두	을 두
을뒤	을 뒤
을들	을 들
을따	을 따
을때	을 때
을마	을 마
을만	을 만
을많	을 많
을말	을 말
을맞	을 맞
을먹	을 먹
을멈춘	을 멈춘
을목표	을 목표
을못	을 못
을받	을 받
을밟	을 밟
을배	을 배
을보	을 보
을복용	을 복용
을볼	을 볼
을빚	을 빚
을빼	을 빼
을사용	을 사용
을삭	을 삭
을살	을 살
을선택	을 선택
을설명	을 설명
을수	을 수
을수있	을 수 있
을시	을 시
을신	을 신
을실	을 실
을실시	을 실시
을썰	을 썰
을쓰	을 쓰
을쓴	을 쓴
을씻	을 씻
을알	을 알
을억제	을 억제
을없	을 없
을예방	을 예방
을움	을 움
을위	을 위
을유지	을 유지
을의	을 의
을의 미	을 의미
을이	을 이
을이 	을 이 
을이해	을 이해
을인용	을 인용
을일	을 일
을잘	을 잘
을정	을 정
을제거	을 제거
을조절	을 조절
을조정	을 조정
을좋	을 좋
을주	을 주
을준	을 준
을줄	을 줄
을증	을 증
을참	을 참
을참고	을 참고
을찾	을 찾
을초래	을 초래
을촉진	을 촉진
을치료	을 치료
을통	을 통
을포함	을 포함
을풀	을 풀
을하	을 하
을하게	을 하게
을한	을 한
을한다	을 한다
을할	을 할
을할 	을 할 
을할수	을 할 수
을함께	을 함께
을함유	을 함유
을했	을 했
을향	을 향
을형성	을 형성
을회복	을 회복
飮	飮
飲	飮
陰 A	陰人
陰 乾	陰乾
陰 經	陰經
陰 交	陰交
음 식	음식
陰 陽	陰陽
음 파	음파
音®	音啞
陰A	陰人
陰踏	陰蹻
음룽	음릉
陰痺帶下	陰痒帶下
음식 물	음식물
陰郑	陰郄
음직	움직
陰짧	陰都
陰華	陰莖
陰桓	陰疽
응용 할	응용할
毅	穀
谊	疽
의 대옹	의 대응
의 이인	의이인
醫 學	醫學
의 학을	의학을
意 했仁	薏苡仁
意;©	薏苡
意\^	薏苡
意\^ 仁	薏苡仁
意\^仁	薏苡仁
醫\*	醫大
意\]茨仁	薏苡仁
意©	薏苡
意©:	薏苡
意©;	薏苡
意®	薏苡
意®:	薏苡
意®;	薏苡
意甘湯	薏甘湯
의같	의 같
의개념	의 개념
醫經	腎經
의경우	의 경우
의경험	의 경험
醫股	臀股
醫과 	腎과 
의굴곡	의 굴곡
醫氣丸	腎氣丸
의대응	의 대응
醫膜	翳膜
醫膜	瞖膜
醫明	翳明
意附	薏附
의뿌	의 뿌
의선택	의 선택
의성숙	의 성숙
醫水	腎水
의시들	의사들
의시윤리	의사윤리
意識	意識
宜伸忌變	宜伸忌鬱
宜伸忌聽	宜伸忌鬱
의신전	의 신전
의이 인	의이인
薏苡 仁	薏苡仁
의이상	의 이상
의작용	의 작용
醫障	翳障
醫正格	腎正格
意졌	薏苡
의중간	의 중간
의증상	의 증상
의측	의 측
의통증	의 통증
醫風	翳風
의학 의 	의학의 
의한에	의한 에
의해에	의해 에
意했仁	薏苡仁
의회전	의 회전
이 것	 이것
이 게 	이게 
이 고 	이고 
이 고 이고 	
이 나 	이나 
이 다\.	이다.
이 두근	이두근
이 라	이라
이 라 	이라 
이 란	이란
이 러	이러
이 론	이론
이 루	이루
이 르	이르
이 면 	이면 
이 외 	 이외 
已 清	已潰
이 후 	 이후 
이\(\*\)	이(裏)
이\(«\)	이(裏)
二A	二人
이P로	이므로
이것 저것	이것저것
이경우	이 경우
二求湯	二朮湯
이나 \^날	이 나타날
이나타	이 나타
이되는	이 되는
이되어	이 되어
이된	이 된
이된 	이 된 
이된다\.	이 된다.
이두근거	이 두근거
이라 고	이라고
이라하	이라 하
이라한다	이라 한다
耳廊	耳廓
이루 	이루
이루 어	이루어
이른 바 	이른바 
이리는	이라는
耳滅	耳鍼
이비 인후	이비인후
이상태	이 상태
耳聲	耳聾
耳誠	耳鍼
以소	以上
耳襲	耳聾
二十五人j	二十五人』
이싱	이상
이없	이 없
이이 	이 이 
이있	이 있
爾積	鬱積
이조건	이 조건
이좋	이 좋
이특징	이 특징
이포함	이 포함
이한다	이 한다
익 기탕	익기탕
익 히	익히
익：>1탕	익기탕
益«1湯	益氣湯
익기 탕	익기탕
益氣渗	益氣湯
益氣游	益氣湯
益氣淸	益氣湯
익기팅	익기탕
茵 i莱萬	茵蔯蒿
人 之	人之
人 參	人參
인 플루	인플루
人\^	사
人F용	사용
인경우	인 경우
인괴론	인과론
人棄臓	人稟臓
茵끓萬	茵蔯蒿
人爹	人蔘
茵藤	茵蔯
人幕	人蔘
寅脈	實脈
人夢	人蔘
人夢湯	人蔘湯
茵薩	茵蔯
人蔘끓	人蔘湯
人蔘游	人蔘湯
인삼人¥	인삼人蔘
人蔘場	人蔘湯
人蔘황	人蔘湯
人赛	人蔘
茵蔬	茵蔯
茵蔬萬	茵蔯蒿
茵蔬嵩	茵蔯蒿
人않의학	사상의학
咽嚼	咽嗌
인증상	인 증상
茵陳	茵蔯
茵陳舊	茵蔯蒿
茵蔯萬	茵蔯蒿
茵陳萬	茵陳蒿
茵陳萬	茵蔯蒿
茵蔯嵩	茵蔯蒿
茵陳嵩	茵蔯蒿
茵蔯惹	茵蔯蒿
人參	人蔘
茵草	茜草
姻蟲	蛔蟲
인판단	인 판단
茵片	苞片
茵蔽萬	茵蔯蒿
茵표萬	茵蔯蒿
姻虫	蛔蟲
日 喃	日晡
일 본	일본
日 分	日分
일 수록	일수록
日 수용체	β 수용체
일 어	일어
일 주일	일주일
일 째	일째
일 치 	일치 
일것	일 것
日喃	日晡
一滅	一鍼
일반 적	일반적
일븐	일본
일어 나	일어나
일지나	일 지나
任 脈	任脈
임 상	임상
임 파	임파
妊娠	姙娠
임싱	임상
入\|•물탕	사물탕
入臉	入腋
入蔽	入腋
있 	있
있 다	있다
있는	있는 
있는다	있는 다
있도 톡	있도록
있디	있다
있어 서	있어서
잎드	엎드
资	資
자 궁	자궁
자 극	자극
自 利	自利
刺 滅	刺鍼
자 살	자살
자 세	자세
자 연	자연
刺 入	刺入
자 주 	자주 
自 汗	自汗
刺M	刺鍼
紫金鍵	紫金錠
紫紐	紫紺
茨茶	茯苓
藉藤	蘿菔
雌藤	雌蕊
雌蓝	雌蕊
紫綠	紫絳
자면이 	자면 이 
刺滅	刺鍼
刺誠	刺鍼
雌蘇	雌蕊
자아이	지이•이
자을 신경	자율신경
자이•	자아
子滴	子癎
藉節	藕節
자주사	자주 사
자주한	자주 한
刺織	刺鍼
茨층	茯苓
子骸	子髎
茨홉	茯苓
茨흉	茯苓
작 약	작약
芍 藥	芍藥
작 용	작용
嚼斜	喎斜
작약 감초탕	작약감초탕
芍藥끓	芍藥湯
芍藥淸	芍藥湯
작약팅	작약탕
芍藥港	芍藥湯
芍藥황	芍藥湯
雀咏	雀啄
작용등	작용 등
嚼吐	嘔吐
잘내	잘 내
잘되	잘 되
赚	風府
잡 아	잡아
잡하면	잡히면
獎	漿
臓	臟
蔵	藏
장 애	장애
장 요근	장요근
張 元	張元
張 仲	張仲
场谷	陽谷
獎果	漿果
臓膽	臟腑
腸瘤	腸癰
張滿	脹滿
장많	장 많
牆脈	蹻脈
長滅	長鍼
场明	陽明
墙味	矯味
臟膝	臟腑
脏娠	姙娠
赃娠	姙娠
腸擁	腸癰
腸癒	腸癰
藏而不淸	藏而不瀉
張子 和	張子和
赃蟲	蟅蟲
臓脆	臓腑
張痛	脹痛
臓贿	臟腑
재 료	재료
再 發	再發
才L	朮
才ᄂ	朮
齋香	麝香
在賢	在腎
猪 膽	猪膽
低 下	低下
저 항	저항
抵 抗	抵抗
猪茶	猪苓
저령 탕	저령탕
著墓朮甘	苓薑朮甘
姐娠	姙娠
猪爷	猪苓
著었仁	薏苡仁
她緩	弛緩
猪측	猪苓
猪품	猪苓
貯疲	貯痰
著했仁	薏苡仁
猪혼	猪苓
猪휴	猪苓
猪흉	猪苓
积	枳
적 당	적당
积 實	枳實
적 용	적용
적 이	적이
적 인 	적인 
적 절	적절
滴肝	瀉肝
积穀	枳穀
赤獨	赤濁
赤铜	赤痢
積鼻	犢鼻
赤小료	赤小豆
积實	枳實
滴心	瀉心
적藥	芍藥
赤与	赤芍
摘圓	橢圓
滴疾	癎疾
敵瘡	斂瘡
积朮	枳朮
적춰	적취
積疲	積痰
적합 한 	적합한 
填	瀉
填	塡
전 립	전립
전 방	전방
전 신	전신
전 체	전체
전 해	전해
전 화	전화
前經骨	前脛骨
戰棵	戰慄
癲狂瘤	癲狂癎
癲狂痴	癲狂癎
錢灸	鍼灸
전딜•	전달
電滅	電鍼
殿粉	澱粉
全赐	全蝎
電誠	電鍼
전이 되	전이되
傳靑主	傅靑主
전체 적	전체적
絕	絶
绝	絶
절 염	절염
截瘡	截瘧
절혼	절흔
漸熱	潮熱
접 근	접근
正 格	正格
정 도 	정도
정 돈	정돈
정 리	정리
정 말	정말
정 맥	정맥
정 상	정상
정 서	정서
精 神	精神
정 액	정액
征 仲	怔忡
情 志	情志
정 체	정체
정 형 	정형 
정 확	정확
정4!	정신
정t!	정신
정기\(精췄	정기(精氣
정도전후	정도 전후
정도혹은	정도 혹은
郑門	郄門
精米	糯米
靜譜	靜謐
정상 적	정상적
정신 과 	정신과 
정藥	芍藥
井榮	井滎
聤耳	聤耳
征仲	怔忡
제 어	제어
제 한	제한
齊IJ	劑
除谷	陰谷
诸茶	猪苓
诸膽	猪膽
蹄脾	歸脾
제상\(脑소	제상(臍上
臍上淨	臍上悸
挤蘇	疥癬
济蘇	疥癬
诸爷	猪苓
济癒	疥癬
诸측	猪苓
济痴	疥癬
诸휴	猪苓
诸흑淸	猪苓湯
졌 	졌
罩	覃
조 미료	조미료
조 직	조직
助間	肋間
助骨	肋骨
조구 등	조구등
燥尿	燥屎
躁磨	躁鬱
助膜	肋膜
躁蠻	躁鬱
조미 료	조미료
躁部	踝部
釣膝散	釣藤散
措溺	搐搦
조직회	조직화
條측	條芩
燥疲	燥痰
條血	瘀血
足 冷	足冷
足 三	足三
足 少	足少
足附	足跗
足瘦	足痿
足祉	足趾
존 재	존재
尊痲疹	蕁麻疹
尊片	萼片
卒中瘦	卒中痙
종 류	종류
種 子	種子
腫\*	腫大
鍾骨	踵骨
腫膽	腫膿
種腾	種臍
腫膜	腫脹
腫膜	腫膿
種膀	種臍
腫服	腫脹
腫腹	腫脹
縱梭	縱稜
腫癌	腫痞
腫張	腫脹
腫中	膻中
縱稷	縱稜
腫臭	腥臭
腫蕩	腫瘍
좋 	좋
좋 을	좋을
좋이이:	좋아야
좌 절	좌절
座攀	痙攣
죄우	좌우
죄측	좌측
주 변	주변
주 위	주위
주 일 	주일 
主 之	主之
主A	主人
周悸	周痺
周库	周痺
湊黎	蒺藜
凑黎	蒺藜
週遙散	逍遙散
酒疲	酒痰
晝黃	薑黃
竹？H 	竹茹
竹\?5	竹茹
竹歷	竹瀝
竹药	竹茹
竹苑	竹茹
竹前溫	竹茹溫
竹節	竹茹
竹妬	竹茹
竹환	竹茹
줄 기	줄기
줄수	줄 수
중 간정도	중간 정도
仲 景	仲景
중 요	중요
중 요한	중요한
中 院	中脘
中 诸	中渚
중간정도	중간 정도
中柩	中樞
中堵	中渚
重獨	重濁
中潘	中渚
中臂俞	中膂俞
중상	증상
中胺	中脘
中腕	中脘
중요 한 	중요한 
中院	中脘
中猪	中渚
中诸	中渚
中骸	中髎
중후군	증후군
즐 	즐
증 가	증가
증 상	증상
症 狀	症狀
증 후	증후
증가 되	증가되
증가 된	증가된
증과치료	증과 치료
증상 을 	증상을 
증상 이 	증상이 
증상이 \^\^난다	증상이 나타난다
증싱	증상
증후 군	증후군
之 	之
之 A	之人
지 고 	지고 
지 굴근	지굴근
지 긋	지긋
지 기 	지기 
지 난	지난
지 면 	지면 
지 속	지속
지 역	지역
지 절	지절
之 症	之症
지 지	지지
지 湯\)	지황)
지\"살	자살
之A	之人
지P로	지므로
地檢	地楡
枳穀	枳殼
止極	止痙
止涛	止瀉
止铜	止痢
肢量	眩暈
止漠	止瀉
지만이 	지만 이 
지맥\(遲M	지맥(遲脈
肢冒	眩冒
지못	지 못
止捧	止痒
紙婦	姙婦
知相地黃	知栢地黃
之腺	之臟
枝薛丸	枝茯苓丸
止瘦	止痙
紙娠	姙娠
枳實蓮白	枳實薤白
지않	지 않
地愉	地楡
지을신경	자율신경
지이\^go	자아ego
지이■	자아
지이•	자아
지이•이	자아이
止嚼	止嘔
知梯	知悌
止清	止瀉
肢最	眩暈
止湯	止瀉
지湯\)	지황)
止择	止痒
지특징	지 특징
止幅	止嘔
之贿	之腑
肢暈	眩暈
肢晕	眩暈
직 임	직임
직 장	직장
직 접	직접
織灸	鍼灸
稷線	稜線
織盛	熾盛
唇	脣
塵	壅
鎮	鎭
진 단	진단
진 찰	진찰
진 피	진피
진 행	진행
秦\^	秦艽
秦II	秦艽
振구	梔子
進滅	進鍼
眞武끓	眞武湯
眞武淸	眞武湯
眞武港	眞武湯
眞武황	眞武湯
鎮物	鑛物
진사실	진 사실
鎭瘦	鎭痙
振水 音	振水音
진우탕	진무탕
振子	梔子
秦표	秦艽
陳下1季	臍下悸
진행 되	진행되
蔯蒿港	蔯蒿湯
질 문	질문
질 병	질병
질 환	질환
疾 患	疾患
侄IJ	倒
질수	질 수
跌風	祛風
질환 을 	질환을 
집이•	잡아
짓 	짓
짓정어	짓찧어
懲	鬱
懲結	鬱結
癥瘕發背	癰疽發背
癥瘕瀉傷	癰疽潰瘍
癥瘕瘡毒	癰疽瘡毒
癥瘕瘡瘍	癰疽瘡瘍
澄黃	橙黃
짖먹이	젖먹이
짧 	짧
짧碑	越婢
쨌 	쨌
쩜질	찜질
쪽끝	쪽 끝
쪽다리	쪽 다리
쪽면	쪽 면
쪽무릎	쪽 무릎
쪽손	쪽 손
쪽어깨	쪽 어깨
쪽지역	쪽 지역
쯤된 	쯤 된 
찌 꺼	찌꺼
ᄎ	大
ᄎ建中	大建中
ᄎ棄	大棗
ᄎ腦	大腦
ᄎ裏	大棗
ᄎ補	大補
ᄎ承氣	大承氣
ᄎ柴胡	大柴胡
ᄎ宗	大宗
ᄎ黃	大黃
ㅊ	大
扯關	趾關
次骸	次髎
着悸	着痺
착긱	착각
着疼	着痺
着痒	着痺
賛	贅
賛抚	贅疣
纂本	藁本
赞傷	燙傷
参	參
참 조	참조
參藍	蓼藍
참쌀	찹쌀
참지아	참자아
蒼 朮	蒼朮
蒼Tit	蒼朮
倉角	皂角
窓論殁	窓論攷
窓論放	窓論攷
窓論汝	窓論攷
瘡不能言	瘖不能言
瘡傷	瘡瘍
槍泄	飱泄
瘡蘇	瘡癬
蒼었仁	薏苡仁
瘡癒	瘡癰
搶轉	捻轉
瘡济	瘡疥
搶挫	捻挫
瘡蕩	瘡瘍
唱吐	嘔吐
찾 	찾
찾이	찾아
채 취	채취
寨本	藁本
책 임	책임
凄	痿
처 럼	처럼
처 방	처방
처 음	처음
處 置	處置
처 해	처해
凄靡	萎靡
凄薄	痿薄
凄璧	痿躄
妻縮	萎縮
척 도	척도
척 수	척수
척 추	척추
薦	瀉
迁	迂
천 식	천식
川 휴	川芎
天\)漏	天牖
天A相	天人相
川g辛夷	川芎辛夷
天騰	天牖
天麻場	天麻湯
擅鼻	犢鼻
川写	川芎
薦心湯	瀉心湯
天牆	天牖
擅竹	攢竹
薦肺	瀉肺
薦下	瀉下
天骸	天髎
薦血	瀉血
川혹	川芎
天豁	天谿
喘效	喘欬
川휴	川芎
叠	疊
清	淸
清	瀉
青	靑
淸 熱	淸熱
清肝	瀉肝
淸悸	淸淨
淸窮	淸竅
靑黨	靑黛
淸獨	淸濁
淸療	潰瘍
靑萬	菁蒿
淸發	淸竅
清白	瀉白
淸傷	潰瘍
靑嵩	靑蒿
淸癌	潰瘍
청藥	芍藥
靑育I湯	靑龍湯
靑育틀	靑龍
淸毅	淸穀
廳頂	巓頂
淸瘡	潰瘍
請請	譩譆
淸蕩	潰瘍
淸痛	潰瘍
清肺	瀉肺
淸疲敗	淸瘟敗
淸下劑	瀉下劑
清火	瀉火
淸痕	潰瘍
滞	滯
체 계	체계
체 적	체적
체 중	체중
체 질	체질
체 형	체형
쳤 	쳤
초 래	초래
초方	古方
焦張	焦脹
触	蝕
촉 지	촉지
촉 진	촉진
燭 活	獨活
觸痛	蠲痛
燭活	獨活
촌구 맥	촌구맥
村后方	肘后方
총 괄	총괄
총門冬 湯	麥門冬湯
總荀	總苞
總茵	總苞
最 近	最近
최 대	최대
枢	樞
추 구	추구
抽捲	抽搐
抽搖	抽搐
抽揺	抽搐
抽搭	抽搐
축 농	축농
蓄膜	蓄膿
축식#기	축삭돌기
축식돌	축삭돌
逐癒	逐瘀
逐疲	逐瘀
출 혈	출혈
출감팅	출감탕
출무탕	출부탕
충 동	충동
충 분	충분
充盛	亢盛
蟲張	蠱脹
充進	亢進
充活	羌活
췌\(勝\)	췌(膵)
취 급	취급
取 穴	取穴
측 굴	측굴
측 면	측면
측 부	측부
측 정	측정
측甘	苓甘
측桂교甘	苓桂朮甘
측歸	芎歸
측墓	苓薑
側臂	側彎
側相	側栢
層乾	脣乾
驰	弛
치 료	치료
治 療	治療
치 성	치성
治 準繩	治準繩
治\^例	治驗例
齒艱	齒齦
致裹	致藁
痴狂	癲狂
齒紐	齒衄
治療痿症	治療效果
치료처방	치료 처방
痴瘤	癲癎
齒離	齒齦
致薬	致藁
致養	致藁
齒銀	齒齦
梔子藥皮	梔子蘗皮
痴疾	癎疾
治疲	治痰
痴皮	痂皮
則 	則
친 다\.	친다.
七敷	七竅
針	鍼
沉	沈
침 구사	침구사
沈IJi	沈脈
沈繁	沈緊
沈運	沈遲
沈秦元	沈麝元
枕核	桃核
칭출	창출
캠술	캡슐
컨 대	컨대
컴플텍스	콤플렉스
케하	케 하
케한다	케 한다
켜 야 	켜야 
켰 	켰
콜 린	콜린
콤 플	콤플
크 	크
큰 술	큰술
큰도움	큰 도움
키 고 	키고 
키 닌	키닌
킨 다	킨다
킬수	킬 수
타 나	타나
타 난	타난
타 내	타내
墮塞	壅塞
墮盛	壅盛
吞	呑
诞	涎
灘腫	癰腫
嘆弦	瞑眩
脫K	脫肛
脫旺	脫肛
脫紅	脫肛
搭	痞
搭滿	痞滿
搭鞭	痞鞭
湯슴	湯合
蕩心湯	瀉心湯
湯火	瀉火
汰	(太
笞	苔
兑	兌
戻	戾
태 도	태도
太 陽	太陽
태 어	태어
太艱	太谿
태양 병	태양병
太陽中嘔	太陽中暍
苔曰	答曰
太湖	太淵
太豁	太谿
澤溝	澤瀉
澤涛	澤瀉
澤薦	澤瀉
澤清	澤瀉
턴藥	芍藥
테 리	테리
테 이	테이
텐신 Ⅱ 	텐신Ⅱ
텐신 II 	텐신Ⅱ
텐신Ⅱ	텐신Ⅱ
텐신II 	텐신Ⅱ
토!	퇴
토！	퇴
토I	퇴
吐紐	吐衄
吐膽	吐膿
吐逆	嘔逆
吐逆感	嘔逆感
吐薦	吐瀉
吐清	吐瀉
吐蕩	吐瀉
吐篇	吐瀉
吐疲	吐痰
통 점	통점
통 제	통제
통 증	통증
痛 症	痛症
통 찰	통찰
통 합	통합
통 해	통해
痛癎	癲癎
通艱	通竅
痛硬	痞硬
痛库	痛痒
通鼓	通竅
痛과 癎	癲과 癎
痛과 狂	癲과 狂
痛狂	癲狂
痛滿	痞滿
痛病多由痰	癲病多由痰
痛痺瘡	痛痒瘡
痛痒	痛痺
痛痒感	瘙痒感
通遙散	逍遙散
通遥散	逍遙散
痛爲心血不足	癲爲心血不足
通毅	通竅
통중	통증
痛疾	癲疾
痛鞭	痞鞭
桶皮	橘皮
腿間	膈間
退滅	退鍼
退醫	退翳
投 與	投與
透疼	透疹
투사 pro	투사pro
透渗	透疹
偷誠	偷鍼
투시pro	투사pro
투여 군	투여군
툭 별	특별
툭 징	특징
트 레	트레
특 별	특별
특 정	특정
특 징	특징
특 히	특히
특窮	芎藭
특歸	芎歸
튼 튼	튼튼
틀 	를 
틀師	醫師
틑 	를 
티 스	티스
파 괴	파괴
파 민	파민
파 악	파악
播库	搔痒
巴료	巴豆
播痺	搔痒
破癒	破癥
播溺	搐搦
辦	瓣
판 단	판단
판 정	판정
辦囊	澼囊
辦膜	瓣膜
팔 꿈	팔꿈
팔 미지황	팔미지황
八 黄丸	八味地黄丸
八\^!黃 丸	八味地黃丸
팔미 지	팔미지
八雜黃丸	八味地黃丸
八八顿黃효	八味地黄丸
八舰黃丸	八味地黃丸
八骸	八髎
沛	疝
牌	脾
敗驚	敗醬
敗毒했	敗毒散
敗蠻	敗醬
敗磐	敗醬
敗碧	敗醬
敗營	敗醬
敗藝	敗醬
敗醫	敗醬
敗暫	敗醬
敗將	敗醬
敗籍	敗醬
敗蓄	敗醬
敗활	敗醬
팬찮	괜찮
膨\*	膨大
膨腹	膨脹
펌근	폄근
鞭	鞕
篇 j	篇」
便 秘	便秘
편 평	편평
篇j	篇』
便賈	便覽
便塘	便溏
便糖	便溏
편두 통	편두통
扁昔\I	扁鵲
篇心湯	瀉心湯
偏擁	偏癱
便이 묶	便이 묽
偏充	偏亢
평7\|	평가
平A	平人
苹藍	葶藶
苹麓	葶藶
平濱	平瀉
平曙散	平胃散
폐 렴	폐렴
蔽 血	瘀血
肺腹	肺脹
肺瘦	肺癰
肺瘦	肺痿
肺癒	肺癰
肺張	肺脹
肺凄	肺痿
蔽下	腋下
蔽血	瘀血
蔽後	腋後
褒	痰
포 함	포함
褒多	痰多
葡萄	葡萄
抱疼	疱疹
泡疼	疱疹
炮墓	炮薑
褒蜜	痰壅
泡渗	疱疹
葡荀	葡葍
抱疫	疱疹
泡疫	疱疹
炮炎	炮炙
褒飮	痰飮
抱子	梔子
炮晝	炮薑
포함 하	포함하
褒咳	痰咳
炮畫	炮薑
幅	嘔
暴庫	暴癉
폭歸	芎歸
暴石	礬石
幅惡	嘔惡
幅逆	嘔逆
幅逆	吐逆
暴瘡	暴瘖
幅吐	嘔吐
幅血	嘔血
폴라보	플라보
폴라시	플라시
표 \(S\)	표(表)
表 面	表面
표杏甘石	麻杏甘石
표현 하	표현하
풀라스	플라스
풀라시	플라시
疯	瘀
風 熱	風熱
풍\(膨	풍(風)
豊角	皂角
風疼	風疹
風摔	風痺
風濕痒	風濕痺
風疲	風痰
風痕	風痰
프 	프
픈것	픈 것
픈쪽	픈 쪽
픈팔	픈 팔
플 러	플러
피 네	피네
疲 勞	疲勞
피 부	피부
皮 膚	皮膚
披 針	披針
皮穀	皮殼
疲多	痰多
皮疼	皮疹
피로 하	피로하
疲攀	痙攣
疲斑	瘀斑
皮膚滅	皮膚鍼
疲盛	痰盛
皮痒	皮痺
疲涎	痰涎
疲軟	痠軟
疲熱	痰熱
疲熱	瘀熱
避遙	逍遙
疲飮	痰飮
疲이	痰이
疲因	痰因
疲核	痰核
疲弦	痰眩
疲血	瘀血
疲火	痰火
必 	必
필 수	필수
필 요	필요
필 자	필자
筆 丸	睾丸
필연 적	필연적
筆丸	睾丸
하 건대	하건대
하 게	하게
하 게 	하게 
하 고 	하고 
하 기	하기
하 기 	하기 
하 는	하는
하 는 	하는 
하 는이	하는 이
하 다\.	하다.
하 더	하더
하 도록	하도록
하 려	하려
下 利	下利
하 며	하며
하 면 	하면 
하 므	하므
하 여 	하여 
하 지	하지
下 肢	下肢
하 지 	하지 
하 지도	하지도
하 지만	하지만
하\^ 	하는 
하H로	하므로
하P로	하므로
하게 \^다\.	하게 된다.
하게하	하게 하
하겨 	하여 
하고 \^음	하고 있음
하고그	하고 그
霞溝	蠡溝
하기도한	하기도 한
下铜	下痢
下铜 	下痢
하루3	하루 3
下利 不止	下利不止
하므로써	함으로써
下敷	下竅
嚇不下	嚥不下
霞砂	蠶砂
瑕石膏	煆石膏
하여이 	하여 이 
瑕用	煆用
下院	下脘
하지 만 	하지만 
下蔽	下腋
下骸	下髎
下險	下瞼
학 자	학자
학 적으로	학적으로
鶴甲	鼈甲
鶴冠	鷄冠
鶴구	鷄子
鶴內金	鷄內金
鶴尿	鷄屎
鶴蛋	鷄蛋
确石	硝石
鶴心	瀉心
學人門	學入門
鶴子	鷄子
鶴掌	鵝掌
학지들	학자들
한 다\.	한다.
한 다고	한다고
한 다는	한다는
寒 凉	寒凉
한 분류	한분류
汗 出	汗出
寒ffi	寒疝
한가지	한 가지
한것	한 것
한것이	한 것이
한게	한 게
한결과	한 결과
한경우	한 경우
한곳	한 곳
한과정	한 과정
한근거	한 근거
한근육	한 근육
한느낌	한 느낌
한다음	한 다음
한디	한다
한디\(그림	한다(그림
한디<그림	한디(그림
한방의 학의	한방의학의
한방의 학적	한방의학적
한번	한 번
한부분	한 부분
한분류	한 분류
한사람	한 사람
한상태	한 상태
한상황	한 상황
한설명	한 설명
한손	한 손
한藥	芍藥
한운동	한 운동
한응용	한 응용
한임상	한 임상
한자세	한 자세
한종자	한 종자
한증상	한 증상
한쪽	한 쪽
한차이	한 차이
한첩	한 첩
한치료	한 치료
한통증	한 통증
한편이 	한편 이 
한효과	한 효과
한효능	한 효능
한후 	한 후 
寒痕	寒痰
할 수록	할수록
할것	할 것
할경우	할 경우
할때	할 때
할뿐	할 뿐
할수	할 수
할수 있	할 수 있
할수없	할 수 없
할수있	할 수 있
喊	噦
함 께	함께
함 유	함유
銜奇	衒奇
함께	 함께
喊味	鹹味
陷四	陷凹
喊逆	喊逆
함유 되	함유되
闔	闔
陕	陜
合 谷	合谷
合 編	合編
합氣丸	腎氣丸
합병 증	합병증
항 상	항상
항생제	 항생제
港合	湯合
抗賢	抗腎
解 S 湯	解毒湯
해 결	해결
解 毒	解毒
해 독탕	해독탕
해 서 	해서 
해 서는	해서는
해 야 	해야 
해 져	해져
해 지고	해지고
해 지면	해지면
해 진다	해진다
解 表	解表
해결정	해 결정
解溪	解谿
解顧	解顱
해독 탕	해독탕
解毒끓	解毒湯
解毒淸	解毒湯
解毒海	解毒湯
해득탕	해독탕
海螺銷	海螵蛸
解絡	解谿
解蠻	解鬱
해백\(難白	해백(薤白
解變	解鬱
解瘦	解痙
해야 \^■다\.	해야 한다.
해야하	해야 하
해야한다	해야 한다
咳淨	咳悸
解怠	懈怠
咳疲	咳痰
解豁	解谿
핵 심	핵심
햇 	햇
햇별	햇볕
했 	했
행 동	행동
行悸	行痺
행군다	헹군다
행동회상ctin	행동화actin
行滅	行鍼
行痒	行痺
鄉	鄕
향 상	향상
향 한	향한
향 해	향해
响斜	喎斜
香薷	香薷
虚	虛
许	忤
허 리	허리
허 약	허약
虛 弱	虛弱
허 증	허증
虛腺	虛脹
虛張	虛脹
許淺	許浚
헉습	학습
憲\^仁	薏苡仁
憲었仁	薏苡仁
憲졌	薏苡
험藥	芍藥
険陽	陰陽
險弦	瞼弦
혀 지	혀지
賢	腎
현 기증	현기증
현 상	현상
현 실	현실
현\(玄\)	현(弦)
弦景	眩暈
懸驚	懸釐
賢氣	腎氣
현기 증	현기증
眩量	眩暈
현맥\(弦膨	현맥(弦脈)
玄夢	玄蔘
賢水	腎水
賢陽	腎陽
賢爲	腎爲
賢은	腎은
賢陰	腎陰
眩章	眩暈
賢藏	腎藏
賢臓	腎臓
賢精	腎精
縣鍾	懸鍾
賢之	腎之
玄參	玄蔘
弦最	眩暈
賢虛	腎虛
弦暈	眩暈
혈 관	혈관
혈 류	혈류
혈 압	혈압
혈 액	혈액
穴 位	穴位
혈\(船	혈(血)
혈OflL\)	혈(血)
血祛癒	血祛瘀
血裙于	血菀于
血铜	血痢
血麻	血瘀
血每	血海
血攀	血鬱
血散癒	血散瘀
혈소 판	혈소판
혈어\(血疲	혈어(血瘀
血癒	血瘀
血蔽	血瘀
血疲	血瘀
血險氣	血隧氣
血痕	血瘀
嫌蟲	蟅蟲
侠	俠
挟	挾
狭	狹
협 조	협조
脅曲	彎曲
狹茶	茯苓
狭茶	茯苓
脇肪	脇肋
狭爷	茯苓
俠裕	俠谿
脇助	脇肋
狭측	茯苓
俠豁	俠谿
狭흑	茯苓
형 성	형성
형 식	형식
형 태	형태
荆茶	荊芥
형藥	芍藥
衡逆	衝逆
형中益氣	補中益氣
慧！茨仁	薏苡仁
慧甘	薏甘
慧抜	薏苡
慧졌仁	薏苡仁
壶	壼
戸	戶
호 르	호르
호 르몬	호르몬
浩 然	浩然
호 흡	호흡
호I	회
毫減	毫鍼
毫滅	毫鍼
號拍	琥珀
호卜	화
毫誠	毫鍼
호藥	芍藥
호톱기	호흡기
乎賢	乎腎
호홉	호흡
호ㅏ	화
혹歸膠	芎歸膠
渾渴	渾濁
混獨	混濁
渾獨	渾濁
혼들	흔들
혼墓	苓薑
昏憤	昏憒
昏情	昏憒
혼히	흔히
홈홈	흠흠
홉기	흡기
홉수	흡수
홉연	흡연
홉입	흡입
紅綠	紅絳
紅幕	紅蔘
紅門	肛門
홍미	흥미
홍분	흥분
홍쇄	흉쇄
弘數	洪數
鴻心	瀉心
洪ᄎ	洪大
紅參	紅蔘
홑트	흩트
화 0X\)	화(火)
花 粉	花粉
花 序	花序
禾IJ	利
花董	花蕾
火戀	火鬱
化膜	化膿
火蠻	火鬱
花弯	花萼
火滅	火鍼
花滅	花鍼
花薄	花萼
花辨	花瓣
禍斜	喎斜
화藥	芍藥
火傲	火熾
化癒	化瘀
花稳	花穗
花尊	花萼
畫汁	薑汁
火織	火熾
火懲	火鬱
花측	茯苓
花痛	花癲
花辦	花瓣
化褒	化痰
化疲	化痰
禾骸	禾髎
畫黃	薑黃
化痕	化痰
확 실	확실
확 인	확인
확藥	芍藥
확羊	羚羊
擴鄉	檳榔
焕	煥
환 경	환경
환 자	환자
喚覺	嗅覺
宦角	皂角
환外의사	환자-의사
환지들	환자들
歡滯	鬱滯
環層	環脣
활 동	활동
활 발	활발
활용 되	활용되
활吐	嘔吐
活血化疲	活血化瘀
黃 S 	黃芪
황 금	황금
况 禁	呪禁
黃 金	黃金
黃 連	黃連
黃 民	黃芪
黃 帝	黃帝
黃S	黃芪
黃柜	黃柏
凰徑	鼠徑
黃考	黃耆
黃夸	黃芩
黃夸湯	黃芩湯
黃禁	黃芩
况禁	呪禁
黃茶	黃芩
黃答	黃苔
黃度湯	黃芪湯
黃等	黃芩
黃掠色	黃棕色
黃萬	黃芪
黃蔑	黃芪
黄苗	黄耆
况巫	呪巫
黃民	黃芪
黃民끓	黃芪湯
皇甫證	皇甫謐
黃복	黃芩
黃賦	黃膩
黄奢 湯	黄耆湯
黃相	黃栢
黃植	黃疸
荒薪子	茺蔚子
黃芸	黃芪
黃耳	黃芩
黃者易	黃芪湯
黃者淸	黃芪湯
黃者湯	黃芪湯
黃者황	黃芪湯
黃帝內®	黃帝內經
黃直	黃疸
黃측	黃芩
黃특	黃芩
黃폭	黃芩
黃혹	黃芩
黃桓	黃疸
黃효	黃芪
黃흑	黃芩
黃痕	黃疸
贿	腑
회 복	회복
회 전	회전
회복용	회 복용
栃子	梔子
徊蟲	蛔蟲
懷懷	懊憹
获	茯
获茶	茯苓
获答	茯苓
获等	茯苓
获神	茯神
获爷	茯苓
획인	확인
获측	茯苓
获품	茯苓
获혼	茯苓
获홉	茯苓
获훈	茯苓
获휴	茯苓
获흉	茯苓
获흡	茯苓
横	橫
횡금	황금
橫腸膜	橫膈膜
橫鄉	檳榔
効	效
효 과	효과
효 능	효능
효 험	효험
효과 가 	효과가 
효과 적	효과적
효괴	효과
效唾	欬唾
횽삼	홍삼
후 박탕	후박탕
後 世	後世
후 통	후통
후桂	苓桂
後茶	茯苓
厚朴끓	厚朴湯
厚朴易	厚朴湯
厚賦	厚膩
喉摔	喉痺
喉娥	喉蛾
喉痒	喉痺
喉嚷	喉嚨
候條j	候條』
喉擦	喉痺
喉嘴	喉嚨
後측	茯苓
喉吐	嘔吐
後혼	茯苓
後豁	後谿
後휴	茯苓
晕	暈
훌學	醫學
훙골	흉골
훙근	흉근
훙쇄	흉쇄
훙추	흉추
喧隔	噎膈
喧孔	瞳孔
喧子黑	瞳子黑
喧腸	噎膈
훼 	훼
虫垂	蟲垂
揮	痺
徽密	緻密
徽盛	熾盛
휴甘	苓甘
흉甘墓味	苓甘薑味
胸隔	胸膈
胸庫	胸痺
胸库	胸痺
胸窟	胸痞
胸唐	胸痞
胸掉	胸痺
胸廊	胸廓
胸廟	胸廓
胸腹腺	胸腹脹
胸捧	胸痺
胸摔	胸痺
胸掩	胸痺
胸院	胸脘
胸腸	胸膈
胸中捧	胸中痺
胸中室	胸中窒
胸中掩	胸中痺
胸搭	胸痞
흉협고 만	흉협고만
胸脇膜痛	胸脇脹痛
흐르 몬	호르몬
黑苦	黑苔
흑歸	芎歸
痕	痰
痕多	痰多
痕獨	痰獨
痕疼	痘疹
痕捧	瘙痒
痕痺	瘙痒
痕濕	痰濕
痕痒	瘙痒
痕涎	痰涎
痕熱	痰熱
痕飮	痰飮
痕血	瘀血
痕火	痰火
흘 리	흘리
흘륭	훌륭
欽	飮
欽	欬
흠삼	홍삼
欽逆	欬逆
흡 수	흡수
흡 연	흡연
흡 인	흡인
흡桂	苓桂
흥 분	흥분
흥골	흉골
흥곽	흉곽
흥근	흉근
흥막염	흉막염
흥쇄	흉쇄
흥추	흉추
흩 	흩
稀塘	稀溏
戲損	虧損
姬娠	姙娠
嬉心	瀉心
喜幅	喜嘔
흿수	횟수
히 지	히지
히"	하
히\^ 	하는 
히\^데	하는데
히·	하
히•	하
히는	하는
히루	하루
히며	하며
히면	하면
히여	하여
히이 	히 이 
히하	히 하
힌다음	힌 다음
ᅭ 인해	으로 인해
는 데\,	는데,
( ){2,}	$1
(^\s*)	
 ”	”학 문	학문
에 의 	에의 
濡學	儒學
르러지	르러 지
소 년	소년
에너무	에 너무
 \)	)
 중가	 증가
올 하	을 하
올 사	을 사
法弱	怯弱
 했	했
 수록 	수록 
外數	外敷
것올	것을
惑	感
勞備	勞倦
署濕	暑濕
發熟	發熱
發然	發熱
細血	衄血
舌普	舌苔
疫痛	疼痛
鼻寒	鼻塞
攻歌	咳嗽
苦黃	苔黃
供數	洪數
推按	拒按
基則	甚則
少普	少苔
壯熟	壯熱
基하	甚하
胸問	胸悶
둣	듯
煩親	煩燥
赤溫	赤澁
齡虛	虧虛
殿冷	厥冷
核歌	咳嗽
니乾	口乾
府紅	脣紅
舌答	舌苔
銀潮散	銀翹散
明乾	咽乾
紫胡	柴胡
加滅	加減
答黃	苔黃
斑逐	斑疹
紅雜	紅絳
竅熱	發熱
抽播	抽搐
使血	便血
接痛	疼痛
使秘	便秘
答白	苔白
便演	便溏
無九	無力
大使	大便
三後鍼	三稜鍼
留鐵	留鍼
刺軟	刺戟
端急	喘急
被風	祛風
能膽	龍膽
端促	喘促
前服	煎服
赤均	赤芍
架胡	柴胡
句藥	芍藥
法答	茯苓
〇}주	아주
字婦	孕婦
黑蒸	熏蒸
牌	脾
四技	四肢
其한	甚한
技體	肢體
溫和炎	溫和灸
端息	喘息
